numeral,enticve1,entifed1,ubicageo_e,municip1,vehreptt,vehrep1,vehrep2,vehrep3,vehreps1,vehrep4,vehrep5,vehrep6,vehreps2,vehrep8,vehrep9,vehrep10,vehreps3,vehrep12,vehrep13,vehrep14
1,01,AGUASCALIENTES,1001,AGUASCALIENTES,47,13,34,0,0,0,0,0,0,0,0,0,47,13,34,0
2,01,AGUASCALIENTES,1002,ASIENTOS,0,0,0,0,0,0,0,0,0,0,0,0,0,0,0,0
3,01,AGUASCALIENTES,1003,CALVILLO,1,1,0,0,0,0,0,0,0,0,0,0,1,1,0,0
4,01,AGUASCALIENTES,1004,COSIO,28,8,20,0,0,0,0,0,0,0,0,0,28,8,20,0
5,01,AGUASCALIENTES,1005,JESUS MARIA,1,1,0,0,0,0,0,0,0,0,0,0,1,1,0,0
6,01,AGUASCALIENTES,1006,PABELLON DE ARTEAGA,2,1,1,0,0,0,0,0,0,0,0,0,2,1,1,0
7,01,AGUASCALIENTES,1007,RINCON DE ROMOS,7,4,3,0,0,0,0,0,0,0,0,0,7,4,3,0
8,01,AGUASCALIENTES,1008,SAN JOSE DE GRACIA,0,0,0,0,0,0,0,0,0,0,0,0,0,0,0,0
9,01,AGUASCALIENTES,1009,TEPEZALA,0,0,0,0,0,0,0,0,0,0,0,0,0,0,0,0
10,01,AGUASCALIENTES,1010,EL LLANO,2,0,2,0,0,0,0,0,0,0,0,0,2,0,2,0
11,01,AGUASCALIENTES,1011,SAN FRANCISCO DE LOS ROMO,5,3,2,0,0,0,0,0,0,0,0,0,5,3,2,0
12,02,BAJA CALIFORNIA,2001,ENSENADA,160,127,33,0,0,0,0,0,0,0,0,0,160,127,33,0
13,02,BAJA CALIFORNIA,2002,MEXICALI,85,48,37,0,0,0,0,0,0,0,0,0,85,48,37,0
14,02,BAJA CALIFORNIA,2003,TECATE,67,46,21,0,0,0,0,0,0,0,0,0,67,46,21,0
15,02,BAJA CALIFORNIA,2004,TIJUANA,339,243,96,0,0,0,0,0,0,0,0,0,339,243,96,0
16,02,BAJA CALIFORNIA,2005,PLAYAS DE ROSARITO,38,35,3,0,0,0,0,0,0,0,0,0,38,35,3,0
17,02,BAJA CALIFORNIA,2006,SAN QUINTIN,0,0,0,0,0,0,0,0,0,0,0,0,0,0,0,0
18,02,BAJA CALIFORNIA,2007,SAN FELIPE,0,0,0,0,0,0,0,0,0,0,0,0,0,0,0,0
19,03,BAJA CALIFORNIA SUR,3001,COMONDU,13,4,9,0,0,0,0,0,0,0,0,0,13,4,9,0
20,03,BAJA CALIFORNIA SUR,3002,MULEGE,12,4,8,0,0,0,0,0,0,0,0,0,12,4,8,0
21,03,BAJA CALIFORNIA SUR,3003,LA PAZ,96,49,47,0,0,0,0,0,0,0,0,0,96,49,47,0
22,03,BAJA CALIFORNIA SUR,3008,LOS CABOS,61,16,45,0,0,0,0,0,0,0,0,0,61,16,45,0
23,03,BAJA CALIFORNIA SUR,3009,LORETO,4,0,4,0,0,0,0,0,0,0,0,0,4,0,4,0
24,04,CAMPECHE,4001,CALKINI,0,0,0,0,0,0,0,0,0,0,0,0,0,0,0,0
25,04,CAMPECHE,4002,CAMPECHE,34,14,20,0,0,0,0,0,0,0,0,0,34,14,20,0
26,04,CAMPECHE,4003,CARMEN,45,12,33,0,0,0,0,0,0,0,0,0,45,12,33,0
27,04,CAMPECHE,4004,CHAMPOTON,24,8,16,0,0,0,0,0,0,0,0,0,24,8,16,0
28,04,CAMPECHE,4005,HECELCHAKAN,0,0,0,0,0,0,0,0,0,0,0,0,0,0,0,0
29,04,CAMPECHE,4006,HOPELCHEN,0,0,0,0,0,0,0,0,0,0,0,0,0,0,0,0
30,04,CAMPECHE,4007,PALIZADA,1,0,1,0,0,0,0,0,0,0,0,0,1,0,1,0
31,04,CAMPECHE,4008,TENABO,0,0,0,0,0,0,0,0,0,0,0,0,0,0,0,0
32,04,CAMPECHE,4009,ESCARCEGA,139,30,109,0,0,0,0,0,0,0,0,0,139,30,109,0
33,04,CAMPECHE,4010,CALAKMUL,9,5,4,0,0,0,0,0,0,0,0,0,9,5,4,0
34,04,CAMPECHE,4011,CANDELARIA,8,1,7,0,0,0,0,0,0,0,0,0,8,1,7,0
35,04,CAMPECHE,4012,SEYBAPLAYA,0,0,0,0,0,0,0,0,0,0,0,0,0,0,0,0
36,04,CAMPECHE,4013,DZITBALCHE,0,0,0,0,0,0,0,0,0,0,0,0,0,0,0,0
37,05,COAHUILA DE ZARAGOZA,5001,ABASOLO,0,0,0,0,0,0,0,0,0,0,0,0,0,0,0,0
38,05,COAHUILA DE ZARAGOZA,5002,ACUÑA,3,1,2,0,0,0,0,0,0,0,0,0,3,1,2,0
39,05,COAHUILA DE ZARAGOZA,5003,ALLENDE,3,0,3,0,0,0,0,0,0,0,0,0,3,0,3,0
40,05,COAHUILA DE ZARAGOZA,5004,ARTEAGA,15,8,7,0,0,0,0,0,0,0,0,0,15,8,7,0
41,05,COAHUILA DE ZARAGOZA,5005,CANDELA,0,0,0,0,0,0,0,0,0,0,0,0,0,0,0,0
42,05,COAHUILA DE ZARAGOZA,5006,CASTAÑOS,14,7,7,0,0,0,0,0,0,0,0,0,14,7,7,0
43,05,COAHUILA DE ZARAGOZA,5007,CUATRO CIENEGAS,1,1,0,0,0,0,0,0,0,0,0,0,1,1,0,0
44,05,COAHUILA DE ZARAGOZA,5008,ESCOBEDO,3,0,3,0,0,0,0,0,0,0,0,0,3,0,3,0
45,05,COAHUILA DE ZARAGOZA,5009,FRANCISCO I MADERO,1,1,0,0,0,0,0,0,0,0,0,0,1,1,0,0
46,05,COAHUILA DE ZARAGOZA,5010,FRONTERA,0,0,0,0,0,0,0,0,0,0,0,0,0,0,0,0
47,05,COAHUILA DE ZARAGOZA,5011,GENERAL CEPEDA,4,2,2,0,0,0,0,0,0,0,0,0,4,2,2,0
48,05,COAHUILA DE ZARAGOZA,5012,GUERRERO,2,0,2,0,0,0,0,0,0,0,0,0,2,0,2,0
49,05,COAHUILA DE ZARAGOZA,5013,HIDALGO,0,0,0,0,0,0,0,0,0,0,0,0,0,0,0,0
50,05,COAHUILA DE ZARAGOZA,5014,JIMENEZ,0,0,0,0,0,0,0,0,0,0,0,0,0,0,0,0
51,05,COAHUILA DE ZARAGOZA,5015,JUAREZ,0,0,0,0,0,0,0,0,0,0,0,0,0,0,0,0
52,05,COAHUILA DE ZARAGOZA,5016,LAMADRID,0,0,0,0,0,0,0,0,0,0,0,0,0,0,0,0
53,05,COAHUILA DE ZARAGOZA,5017,MATAMOROS,1,0,1,0,0,0,0,0,0,0,0,0,1,0,1,0
54,05,COAHUILA DE ZARAGOZA,5018,MONCLOVA,15,3,12,0,0,0,0,0,0,0,0,0,15,3,12,0
55,05,COAHUILA DE ZARAGOZA,5019,MORELOS,0,0,0,0,0,0,0,0,0,0,0,0,0,0,0,0
56,05,COAHUILA DE ZARAGOZA,5020,MUZQUIZ,0,0,0,0,0,0,0,0,0,0,0,0,0,0,0,0
57,05,COAHUILA DE ZARAGOZA,5021,NADADORES,0,0,0,0,0,0,0,0,0,0,0,0,0,0,0,0
58,05,COAHUILA DE ZARAGOZA,5022,NAVA,0,0,0,0,0,0,0,0,0,0,0,0,0,0,0,0
59,05,COAHUILA DE ZARAGOZA,5023,OCAMPO,0,0,0,0,0,0,0,0,0,0,0,0,0,0,0,0
60,05,COAHUILA DE ZARAGOZA,5024,PARRAS,8,6,2,0,0,0,0,0,0,0,0,0,8,6,2,0
61,05,COAHUILA DE ZARAGOZA,5025,PIEDRAS NEGRAS,1,0,1,0,0,0,0,0,0,0,0,0,1,0,1,0
62,05,COAHUILA DE ZARAGOZA,5026,PROGRESO,0,0,0,0,0,0,0,0,0,0,0,0,0,0,0,0
63,05,COAHUILA DE ZARAGOZA,5027,RAMOS ARIZPE,113,22,91,0,0,0,0,0,0,0,0,0,113,22,91,0
64,05,COAHUILA DE ZARAGOZA,5028,SABINAS,2,2,0,0,0,0,0,0,0,0,0,0,2,2,0,0
65,05,COAHUILA DE ZARAGOZA,5029,SACRAMENTO,0,0,0,0,0,0,0,0,0,0,0,0,0,0,0,0
66,05,COAHUILA DE ZARAGOZA,5030,SALTILLO,37,7,30,0,0,0,0,0,0,0,0,0,37,7,30,0
67,05,COAHUILA DE ZARAGOZA,5031,SAN BUENAVENTURA,0,0,0,0,0,0,0,0,0,0,0,0,0,0,0,0
68,05,COAHUILA DE ZARAGOZA,5032,SAN JUAN DE SABINAS,0,0,0,0,0,0,0,0,0,0,0,0,0,0,0,0
69,05,COAHUILA DE ZARAGOZA,5033,SAN PEDRO,9,5,4,0,0,0,0,0,0,0,0,0,9,5,4,0
70,05,COAHUILA DE ZARAGOZA,5034,SIERRA MOJADA,0,0,0,0,0,0,0,0,0,0,0,0,0,0,0,0
71,05,COAHUILA DE ZARAGOZA,5035,TORREON,14,6,8,0,0,0,0,0,0,0,0,0,14,6,8,0
72,05,COAHUILA DE ZARAGOZA,5036,VIESCA,0,0,0,0,0,0,0,0,0,0,0,0,0,0,0,0
73,05,COAHUILA DE ZARAGOZA,5037,VILLA UNION,0,0,0,0,0,0,0,0,0,0,0,0,0,0,0,0
74,05,COAHUILA DE ZARAGOZA,5038,ZARAGOZA,0,0,0,0,0,0,0,0,0,0,0,0,0,0,0,0
75,06,COLIMA,6001,ARMERIA,1,0,1,0,0,0,0,0,0,0,0,0,1,0,1,0
76,06,COLIMA,6002,COLIMA,69,19,50,0,0,0,0,0,0,0,0,0,69,19,50,0
77,06,COLIMA,6003,COMALA,0,0,0,0,0,0,0,0,0,0,0,0,0,0,0,0
78,06,COLIMA,6004,COQUIMATLAN,0,0,0,0,0,0,0,0,0,0,0,0,0,0,0,0
79,06,COLIMA,6005,CUAUHTEMOC,29,5,24,0,0,0,0,0,0,0,0,0,29,5,24,0
80,06,COLIMA,6006,IXTLAHUACAN,0,0,0,0,0,0,0,0,0,0,0,0,0,0,0,0
81,06,COLIMA,6007,MANZANILLO,65,29,36,0,0,0,0,0,0,0,0,0,65,29,36,0
82,06,COLIMA,6008,MINATITLAN,0,0,0,0,0,0,0,0,0,0,0,0,0,0,0,0
83,06,COLIMA,6009,TECOMAN,54,14,40,0,0,0,0,0,0,0,0,0,54,14,40,0
84,06,COLIMA,6010,VILLA DE ALVAREZ,0,0,0,0,0,0,0,0,0,0,0,0,0,0,0,0
85,07,CHIAPAS,7001,ACACOYAGUA,1,1,0,0,0,0,0,0,0,0,0,0,1,1,0,0
86,07,CHIAPAS,7002,ACALA,0,0,0,0,0,0,0,0,0,0,0,0,0,0,0,0
87,07,CHIAPAS,7003,ACAPETAHUA,0,0,0,0,0,0,0,0,0,0,0,0,0,0,0,0
88,07,CHIAPAS,7004,ALTAMIRANO,0,0,0,0,0,0,0,0,0,0,0,0,0,0,0,0
89,07,CHIAPAS,7005,AMATAN,0,0,0,0,0,0,0,0,0,0,0,0,0,0,0,0
90,07,CHIAPAS,7006,AMATENANGO DE LA FRONTERA,1,1,0,0,0,0,0,0,0,0,0,0,1,1,0,0
91,07,CHIAPAS,7007,AMATENANGO DEL VALLE,0,0,0,0,0,0,0,0,0,0,0,0,0,0,0,0
92,07,CHIAPAS,7008,ANGEL ALBINO CORZO,0,0,0,0,0,0,0,0,0,0,0,0,0,0,0,0
93,07,CHIAPAS,7009,ARRIAGA,5,2,3,0,0,0,0,0,0,0,0,0,5,2,3,0
94,07,CHIAPAS,7010,BEJUCAL DE OCAMPO,0,0,0,0,0,0,0,0,0,0,0,0,0,0,0,0
95,07,CHIAPAS,7011,BELLA VISTA,0,0,0,0,0,0,0,0,0,0,0,0,0,0,0,0
96,07,CHIAPAS,7012,BERRIOZABAL,13,3,10,0,0,0,0,0,0,0,0,0,13,3,10,0
97,07,CHIAPAS,7013,BOCHIL,0,0,0,0,0,0,0,0,0,0,0,0,0,0,0,0
98,07,CHIAPAS,7014,EL BOSQUE,0,0,0,0,0,0,0,0,0,0,0,0,0,0,0,0
99,07,CHIAPAS,7015,CACAHOATAN,0,0,0,0,0,0,0,0,0,0,0,0,0,0,0,0
100,07,CHIAPAS,7016,CATAZAJA,2,1,1,0,0,0,0,0,0,0,0,0,2,1,1,0
101,07,CHIAPAS,7017,CINTALAPA,2,0,2,0,0,0,0,0,0,0,0,0,2,0,2,0
102,07,CHIAPAS,7018,COAPILLA,0,0,0,0,0,0,0,0,0,0,0,0,0,0,0,0
103,07,CHIAPAS,7019,COMITAN DE DOMINGUEZ,8,2,6,0,0,0,0,0,0,0,0,0,8,2,6,0
104,07,CHIAPAS,7020,LA CONCORDIA,0,0,0,0,0,0,0,0,0,0,0,0,0,0,0,0
105,07,CHIAPAS,7021,COPAINALA,0,0,0,0,0,0,0,0,0,0,0,0,0,0,0,0
106,07,CHIAPAS,7022,CHALCHIHUITAN,0,0,0,0,0,0,0,0,0,0,0,0,0,0,0,0
107,07,CHIAPAS,7023,CHAMULA,0,0,0,0,0,0,0,0,0,0,0,0,0,0,0,0
108,07,CHIAPAS,7024,CHANAL,0,0,0,0,0,0,0,0,0,0,0,0,0,0,0,0
109,07,CHIAPAS,7025,CHAPULTENANGO,0,0,0,0,0,0,0,0,0,0,0,0,0,0,0,0
110,07,CHIAPAS,7026,CHENALHO,0,0,0,0,0,0,0,0,0,0,0,0,0,0,0,0
111,07,CHIAPAS,7027,CHIAPA DE CORZO,9,2,7,0,1,0,1,0,0,0,0,0,8,2,6,0
112,07,CHIAPAS,7028,CHIAPILLA,0,0,0,0,0,0,0,0,0,0,0,0,0,0,0,0
113,07,CHIAPAS,7029,CHICOASEN,2,1,1,0,0,0,0,0,0,0,0,0,2,1,1,0
114,07,CHIAPAS,7030,CHICOMUSELO,0,0,0,0,0,0,0,0,0,0,0,0,0,0,0,0
115,07,CHIAPAS,7031,CHILON,0,0,0,0,0,0,0,0,0,0,0,0,0,0,0,0
116,07,CHIAPAS,7032,ESCUINTLA,3,1,2,0,0,0,0,0,0,0,0,0,3,1,2,0
117,07,CHIAPAS,7033,FRANCISCO LEON,0,0,0,0,0,0,0,0,0,0,0,0,0,0,0,0
118,07,CHIAPAS,7034,FRONTERA COMALAPA,1,1,0,0,0,0,0,0,0,0,0,0,1,1,0,0
119,07,CHIAPAS,7035,FRONTERA HIDALGO,1,0,1,0,0,0,0,0,0,0,0,0,1,0,1,0
120,07,CHIAPAS,7036,LA GRANDEZA,0,0,0,0,0,0,0,0,0,0,0,0,0,0,0,0
121,07,CHIAPAS,7037,HUEHUETAN,0,0,0,0,0,0,0,0,0,0,0,0,0,0,0,0
122,07,CHIAPAS,7038,HUIXTAN,0,0,0,0,0,0,0,0,0,0,0,0,0,0,0,0
123,07,CHIAPAS,7039,HUITIUPAN,0,0,0,0,0,0,0,0,0,0,0,0,0,0,0,0
124,07,CHIAPAS,7040,HUIXTLA,1,0,1,0,0,0,0,0,0,0,0,0,1,0,1,0
125,07,CHIAPAS,7041,LA INDEPENDENCIA,0,0,0,0,0,0,0,0,0,0,0,0,0,0,0,0
126,07,CHIAPAS,7042,IXHUATAN,0,0,0,0,0,0,0,0,0,0,0,0,0,0,0,0
127,07,CHIAPAS,7043,IXTACOMITAN,0,0,0,0,0,0,0,0,0,0,0,0,0,0,0,0
128,07,CHIAPAS,7044,IXTAPA,0,0,0,0,0,0,0,0,0,0,0,0,0,0,0,0
129,07,CHIAPAS,7045,IXTAPANGAJOYA,0,0,0,0,0,0,0,0,0,0,0,0,0,0,0,0
130,07,CHIAPAS,7046,JIQUIPILAS,4,3,1,0,0,0,0,0,0,0,0,0,4,3,1,0
131,07,CHIAPAS,7047,JITOTOL,1,0,1,0,0,0,0,0,0,0,0,0,1,0,1,0
132,07,CHIAPAS,7048,JUAREZ,0,0,0,0,0,0,0,0,0,0,0,0,0,0,0,0
133,07,CHIAPAS,7049,LARRAINZAR,0,0,0,0,0,0,0,0,0,0,0,0,0,0,0,0
134,07,CHIAPAS,7050,LA LIBERTAD,0,0,0,0,0,0,0,0,0,0,0,0,0,0,0,0
135,07,CHIAPAS,7051,MAPASTEPEC,1,1,0,0,0,0,0,0,0,0,0,0,1,1,0,0
136,07,CHIAPAS,7052,LAS MARGARITAS,0,0,0,0,0,0,0,0,0,0,0,0,0,0,0,0
137,07,CHIAPAS,7053,MAZAPA DE MADERO,0,0,0,0,0,0,0,0,0,0,0,0,0,0,0,0
138,07,CHIAPAS,7054,MAZATAN,0,0,0,0,0,0,0,0,0,0,0,0,0,0,0,0
139,07,CHIAPAS,7055,METAPA,4,0,4,0,0,0,0,0,0,0,0,0,4,0,4,0
140,07,CHIAPAS,7056,MITONTIC,0,0,0,0,0,0,0,0,0,0,0,0,0,0,0,0
141,07,CHIAPAS,7057,MOTOZINTLA,0,0,0,0,0,0,0,0,0,0,0,0,0,0,0,0
142,07,CHIAPAS,7058,NICOLAS RUIZ,0,0,0,0,0,0,0,0,0,0,0,0,0,0,0,0
143,07,CHIAPAS,7059,OCOSINGO,2,0,2,0,0,0,0,0,0,0,0,0,2,0,2,0
144,07,CHIAPAS,7060,OCOTEPEC,0,0,0,0,0,0,0,0,0,0,0,0,0,0,0,0
145,07,CHIAPAS,7061,OCOZOCOAUTLA DE ESPINOSA,43,2,41,0,0,0,0,0,0,0,0,0,43,2,41,0
146,07,CHIAPAS,7062,OSTUACAN,4,1,3,0,0,0,0,0,0,0,0,0,4,1,3,0
147,07,CHIAPAS,7063,OSUMACINTA,0,0,0,0,0,0,0,0,0,0,0,0,0,0,0,0
148,07,CHIAPAS,7064,OXCHUC,0,0,0,0,0,0,0,0,0,0,0,0,0,0,0,0
149,07,CHIAPAS,7065,PALENQUE,51,11,40,0,1,0,1,0,0,0,0,0,50,11,39,0
150,07,CHIAPAS,7066,PANTELHO,0,0,0,0,0,0,0,0,0,0,0,0,0,0,0,0
151,07,CHIAPAS,7067,PANTEPEC,0,0,0,0,0,0,0,0,0,0,0,0,0,0,0,0
152,07,CHIAPAS,7068,PICHUCALCO,1,0,1,0,0,0,0,0,0,0,0,0,1,0,1,0
153,07,CHIAPAS,7069,PIJIJIAPAN,6,1,5,0,0,0,0,0,0,0,0,0,6,1,5,0
154,07,CHIAPAS,7070,EL PORVENIR,0,0,0,0,0,0,0,0,0,0,0,0,0,0,0,0
155,07,CHIAPAS,7071,VILLA COMALTITLAN,1,1,0,0,0,0,0,0,0,0,0,0,1,1,0,0
156,07,CHIAPAS,7072,PUEBLO NUEVO SOLISTAHUACAN,5,5,0,0,0,0,0,0,0,0,0,0,5,5,0,0
157,07,CHIAPAS,7073,RAYON,0,0,0,0,0,0,0,0,0,0,0,0,0,0,0,0
158,07,CHIAPAS,7074,REFORMA,0,0,0,0,0,0,0,0,0,0,0,0,0,0,0,0
159,07,CHIAPAS,7075,LAS ROSAS,0,0,0,0,0,0,0,0,0,0,0,0,0,0,0,0
160,07,CHIAPAS,7076,SABANILLA,0,0,0,0,0,0,0,0,0,0,0,0,0,0,0,0
161,07,CHIAPAS,7077,SALTO DE AGUA,0,0,0,0,0,0,0,0,0,0,0,0,0,0,0,0
162,07,CHIAPAS,7078,SAN CRISTOBAL DE LAS CASAS,4,4,0,0,0,0,0,0,0,0,0,0,4,4,0,0
163,07,CHIAPAS,7079,SAN FERNANDO,2,0,2,0,0,0,0,0,0,0,0,0,2,0,2,0
164,07,CHIAPAS,7080,SILTEPEC,0,0,0,0,0,0,0,0,0,0,0,0,0,0,0,0
165,07,CHIAPAS,7081,SIMOJOVEL,0,0,0,0,0,0,0,0,0,0,0,0,0,0,0,0
166,07,CHIAPAS,7082,SITALA,1,1,0,0,0,0,0,0,0,0,0,0,1,1,0,0
167,07,CHIAPAS,7083,SOCOLTENANGO,0,0,0,0,0,0,0,0,0,0,0,0,0,0,0,0
168,07,CHIAPAS,7084,SOLOSUCHIAPA,0,0,0,0,0,0,0,0,0,0,0,0,0,0,0,0
169,07,CHIAPAS,7085,SOYALO,0,0,0,0,0,0,0,0,0,0,0,0,0,0,0,0
170,07,CHIAPAS,7086,SUCHIAPA,0,0,0,0,0,0,0,0,0,0,0,0,0,0,0,0
171,07,CHIAPAS,7087,SUCHIATE,4,1,3,0,0,0,0,0,0,0,0,0,4,1,3,0
172,07,CHIAPAS,7088,SUNUAPA,0,0,0,0,0,0,0,0,0,0,0,0,0,0,0,0
173,07,CHIAPAS,7089,TAPACHULA,28,0,28,0,0,0,0,0,0,0,0,0,28,0,28,0
174,07,CHIAPAS,7090,TAPALAPA,0,0,0,0,0,0,0,0,0,0,0,0,0,0,0,0
175,07,CHIAPAS,7091,TAPILULA,0,0,0,0,0,0,0,0,0,0,0,0,0,0,0,0
176,07,CHIAPAS,7092,TECPATAN,6,0,6,0,0,0,0,0,0,0,0,0,6,0,6,0
177,07,CHIAPAS,7093,TENEJAPA,0,0,0,0,0,0,0,0,0,0,0,0,0,0,0,0
178,07,CHIAPAS,7094,TEOPISCA,1,1,0,0,0,0,0,0,0,0,0,0,1,1,0,0
179,07,CHIAPAS,7096,TILA,0,0,0,0,0,0,0,0,0,0,0,0,0,0,0,0
180,07,CHIAPAS,7097,TONALA,2,0,2,0,0,0,0,0,0,0,0,0,2,0,2,0
181,07,CHIAPAS,7098,TOTOLAPA,0,0,0,0,0,0,0,0,0,0,0,0,0,0,0,0
182,07,CHIAPAS,7099,LA TRINITARIA,20,14,6,0,0,0,0,0,0,0,0,0,20,14,6,0
183,07,CHIAPAS,7100,TUMBALA,0,0,0,0,0,0,0,0,0,0,0,0,0,0,0,0
184,07,CHIAPAS,7101,TUXTLA GUTIERREZ,11,2,9,0,0,0,0,0,0,0,0,0,11,2,9,0
185,07,CHIAPAS,7102,TUXTLA CHICO,1,0,1,0,0,0,0,0,0,0,0,0,1,0,1,0
186,07,CHIAPAS,7103,TUZANTAN,1,0,1,0,0,0,0,0,0,0,0,0,1,0,1,0
187,07,CHIAPAS,7104,TZIMOL,0,0,0,0,0,0,0,0,0,0,0,0,0,0,0,0
188,07,CHIAPAS,7105,UNION JUAREZ,0,0,0,0,0,0,0,0,0,0,0,0,0,0,0,0
189,07,CHIAPAS,7106,VENUSTIANO CARRANZA,0,0,0,0,0,0,0,0,0,0,0,0,0,0,0,0
190,07,CHIAPAS,7107,VILLA CORZO,0,0,0,0,0,0,0,0,0,0,0,0,0,0,0,0
191,07,CHIAPAS,7108,VILLAFLORES,0,0,0,0,0,0,0,0,0,0,0,0,0,0,0,0
192,07,CHIAPAS,7109,YAJALON,0,0,0,0,0,0,0,0,0,0,0,0,0,0,0,0
193,07,CHIAPAS,7110,SAN LUCAS,0,0,0,0,0,0,0,0,0,0,0,0,0,0,0,0
194,07,CHIAPAS,7111,ZINACANTAN,0,0,0,0,0,0,0,0,0,0,0,0,0,0,0,0
195,07,CHIAPAS,7112,SAN JUAN CANCUC,0,0,0,0,0,0,0,0,0,0,0,0,0,0,0,0
196,07,CHIAPAS,7113,ALDAMA,0,0,0,0,0,0,0,0,0,0,0,0,0,0,0,0
197,07,CHIAPAS,7114,BENEMERITO DE LAS AMERICAS,0,0,0,0,0,0,0,0,0,0,0,0,0,0,0,0
198,07,CHIAPAS,7115,MARAVILLA TENEJAPA,0,0,0,0,0,0,0,0,0,0,0,0,0,0,0,0
199,07,CHIAPAS,7116,MARQUES DE COMILLAS,0,0,0,0,0,0,0,0,0,0,0,0,0,0,0,0
200,07,CHIAPAS,7117,MONTECRISTO DE GUERRERO,0,0,0,0,0,0,0,0,0,0,0,0,0,0,0,0
201,07,CHIAPAS,7118,SAN ANDRES DURAZNAL,0,0,0,0,0,0,0,0,0,0,0,0,0,0,0,0
202,07,CHIAPAS,7119,SANTIAGO EL PINAR,0,0,0,0,0,0,0,0,0,0,0,0,0,0,0,0
203,07,CHIAPAS,7120,CAPITAN LUIS ANGEL VIDAL,0,0,0,0,0,0,0,0,0,0,0,0,0,0,0,0
204,07,CHIAPAS,7121,RINCON CHAMULA SAN PEDRO,0,0,0,0,0,0,0,0,0,0,0,0,0,0,0,0
205,07,CHIAPAS,7122,EL PARRAL,0,0,0,0,0,0,0,0,0,0,0,0,0,0,0,0
206,07,CHIAPAS,7123,EMILIANO ZAPATA,0,0,0,0,0,0,0,0,0,0,0,0,0,0,0,0
207,07,CHIAPAS,7124,MEZCALAPA,0,0,0,0,0,0,0,0,0,0,0,0,0,0,0,0
208,07,CHIAPAS,7125,HONDURAS DE LA SIERRA,0,0,0,0,0,0,0,0,0,0,0,0,0,0,0,0
209,08,CHIHUAHUA,8001,AHUMADA,50,2,48,0,0,0,0,0,0,0,0,0,50,2,48,0
210,08,CHIHUAHUA,8002,ALDAMA,3,1,2,0,0,0,0,0,0,0,0,0,3,1,2,0
211,08,CHIHUAHUA,8003,ALLENDE,0,0,0,0,0,0,0,0,0,0,0,0,0,0,0,0
212,08,CHIHUAHUA,8004,AQUILES SERDAN,0,0,0,0,0,0,0,0,0,0,0,0,0,0,0,0
213,08,CHIHUAHUA,8005,ASCENSION,38,2,36,0,0,0,0,0,0,0,0,0,38,2,36,0
214,08,CHIHUAHUA,8006,BACHINIVA,0,0,0,0,0,0,0,0,0,0,0,0,0,0,0,0
215,08,CHIHUAHUA,8007,BALLEZA,0,0,0,0,0,0,0,0,0,0,0,0,0,0,0,0
216,08,CHIHUAHUA,8008,BATOPILAS DE MANUEL GOMEZ MORIN,0,0,0,0,0,0,0,0,0,0,0,0,0,0,0,0
217,08,CHIHUAHUA,8009,BOCOYNA,0,0,0,0,0,0,0,0,0,0,0,0,0,0,0,0
218,08,CHIHUAHUA,8010,BUENAVENTURA,1,1,0,0,0,0,0,0,0,0,0,0,1,1,0,0
219,08,CHIHUAHUA,8011,CAMARGO,6,0,6,0,0,0,0,0,0,0,0,0,6,0,6,0
220,08,CHIHUAHUA,8012,CARICHI,0,0,0,0,0,0,0,0,0,0,0,0,0,0,0,0
221,08,CHIHUAHUA,8013,CASAS GRANDES,6,0,6,0,0,0,0,0,0,0,0,0,6,0,6,0
222,08,CHIHUAHUA,8014,CORONADO,0,0,0,0,0,0,0,0,0,0,0,0,0,0,0,0
223,08,CHIHUAHUA,8015,COYAME DEL SOTOL,0,0,0,0,0,0,0,0,0,0,0,0,0,0,0,0
224,08,CHIHUAHUA,8016,LA CRUZ,0,0,0,0,0,0,0,0,0,0,0,0,0,0,0,0
225,08,CHIHUAHUA,8017,CUAUHTEMOC,16,6,10,0,0,0,0,0,0,0,0,0,16,6,10,0
226,08,CHIHUAHUA,8018,CUSIHUIRIACHI,1,1,0,0,0,0,0,0,0,0,0,0,1,1,0,0
227,08,CHIHUAHUA,8019,CHIHUAHUA,149,35,114,0,1,0,1,0,0,0,0,0,148,35,113,0
228,08,CHIHUAHUA,8020,CHINIPAS,0,0,0,0,0,0,0,0,0,0,0,0,0,0,0,0
229,08,CHIHUAHUA,8021,DELICIAS,73,8,65,0,0,0,0,0,0,0,0,0,73,8,65,0
230,08,CHIHUAHUA,8022,DR BELISARIO DOMINGUEZ,0,0,0,0,0,0,0,0,0,0,0,0,0,0,0,0
231,08,CHIHUAHUA,8023,GALEANA,5,3,2,0,0,0,0,0,0,0,0,0,5,3,2,0
232,08,CHIHUAHUA,8024,SANTA ISABEL,38,6,32,0,0,0,0,0,0,0,0,0,38,6,32,0
233,08,CHIHUAHUA,8025,GOMEZ FARIAS,0,0,0,0,0,0,0,0,0,0,0,0,0,0,0,0
234,08,CHIHUAHUA,8026,GRAN MORELOS,35,3,32,0,0,0,0,0,0,0,0,0,35,3,32,0
235,08,CHIHUAHUA,8027,GUACHOCHI,3,3,0,0,0,0,0,0,0,0,0,0,3,3,0,0
236,08,CHIHUAHUA,8028,GUADALUPE,1,0,1,0,0,0,0,0,0,0,0,0,1,0,1,0
237,08,CHIHUAHUA,8029,GUADALUPE Y CALVO,0,0,0,0,0,0,0,0,0,0,0,0,0,0,0,0
238,08,CHIHUAHUA,8030,GUAZAPARES,0,0,0,0,0,0,0,0,0,0,0,0,0,0,0,0
239,08,CHIHUAHUA,8031,GUERRERO,7,0,7,0,0,0,0,0,0,0,0,0,7,0,7,0
240,08,CHIHUAHUA,8032,HIDALGO DEL PARRAL,58,6,52,0,0,0,0,0,0,0,0,0,58,6,52,0
241,08,CHIHUAHUA,8033,HUEJOTITAN,0,0,0,0,0,0,0,0,0,0,0,0,0,0,0,0
242,08,CHIHUAHUA,8034,IGNACIO ZARAGOZA,0,0,0,0,0,0,0,0,0,0,0,0,0,0,0,0
243,08,CHIHUAHUA,8035,JANOS,3,1,2,0,0,0,0,0,0,0,0,0,3,1,2,0
244,08,CHIHUAHUA,8036,JIMENEZ,65,2,63,0,0,0,0,0,0,0,0,0,65,2,63,0
245,08,CHIHUAHUA,8037,JUAREZ,166,17,149,0,0,0,0,0,0,0,0,0,166,17,149,0
246,08,CHIHUAHUA,8038,JULIMES,0,0,0,0,0,0,0,0,0,0,0,0,0,0,0,0
247,08,CHIHUAHUA,8039,LOPEZ,0,0,0,0,0,0,0,0,0,0,0,0,0,0,0,0
248,08,CHIHUAHUA,8040,MADERA,0,0,0,0,0,0,0,0,0,0,0,0,0,0,0,0
249,08,CHIHUAHUA,8041,MAGUARICHI,0,0,0,0,0,0,0,0,0,0,0,0,0,0,0,0
250,08,CHIHUAHUA,8042,MANUEL BENAVIDES,0,0,0,0,0,0,0,0,0,0,0,0,0,0,0,0
251,08,CHIHUAHUA,8043,MATACHI,0,0,0,0,0,0,0,0,0,0,0,0,0,0,0,0
252,08,CHIHUAHUA,8044,MATAMOROS,2,2,0,0,0,0,0,0,0,0,0,0,2,2,0,0
253,08,CHIHUAHUA,8045,MEOQUI,9,1,8,0,0,0,0,0,0,0,0,0,9,1,8,0
254,08,CHIHUAHUA,8046,MORELOS,0,0,0,0,0,0,0,0,0,0,0,0,0,0,0,0
255,08,CHIHUAHUA,8047,MORIS,0,0,0,0,0,0,0,0,0,0,0,0,0,0,0,0
256,08,CHIHUAHUA,8048,NAMIQUIPA,0,0,0,0,0,0,0,0,0,0,0,0,0,0,0,0
257,08,CHIHUAHUA,8049,NONOAVA,0,0,0,0,0,0,0,0,0,0,0,0,0,0,0,0
258,08,CHIHUAHUA,8050,NUEVO CASAS GRANDES,21,3,18,0,0,0,0,0,0,0,0,0,21,3,18,0
259,08,CHIHUAHUA,8051,OCAMPO,0,0,0,0,0,0,0,0,0,0,0,0,0,0,0,0
260,08,CHIHUAHUA,8052,OJINAGA,16,1,15,0,0,0,0,0,0,0,0,0,16,1,15,0
261,08,CHIHUAHUA,8053,PRAXEDIS G GUERRERO,0,0,0,0,0,0,0,0,0,0,0,0,0,0,0,0
262,08,CHIHUAHUA,8054,RIVA PALACIO,0,0,0,0,0,0,0,0,0,0,0,0,0,0,0,0
263,08,CHIHUAHUA,8055,ROSALES,0,0,0,0,0,0,0,0,0,0,0,0,0,0,0,0
264,08,CHIHUAHUA,8056,ROSARIO,0,0,0,0,0,0,0,0,0,0,0,0,0,0,0,0
265,08,CHIHUAHUA,8057,SAN FRANCISCO DE BORJA,0,0,0,0,0,0,0,0,0,0,0,0,0,0,0,0
266,08,CHIHUAHUA,8058,SAN FRANCISCO DE CONCHOS,0,0,0,0,0,0,0,0,0,0,0,0,0,0,0,0
267,08,CHIHUAHUA,8059,SAN FRANCISCO DEL ORO,2,1,1,0,0,0,0,0,0,0,0,0,2,1,1,0
268,08,CHIHUAHUA,8060,SANTA BARBARA,0,0,0,0,0,0,0,0,0,0,0,0,0,0,0,0
269,08,CHIHUAHUA,8061,SATEVO,1,0,1,0,0,0,0,0,0,0,0,0,1,0,1,0
270,08,CHIHUAHUA,8062,SAUCILLO,61,3,58,0,0,0,0,0,0,0,0,0,61,3,58,0
271,08,CHIHUAHUA,8063,TEMOSACHIC,0,0,0,0,0,0,0,0,0,0,0,0,0,0,0,0
272,08,CHIHUAHUA,8064,EL TULE,0,0,0,0,0,0,0,0,0,0,0,0,0,0,0,0
273,08,CHIHUAHUA,8065,URIQUE,0,0,0,0,0,0,0,0,0,0,0,0,0,0,0,0
274,08,CHIHUAHUA,8066,URUACHI,0,0,0,0,0,0,0,0,0,0,0,0,0,0,0,0
275,08,CHIHUAHUA,8067,VALLE DE ZARAGOZA,0,0,0,0,0,0,0,0,0,0,0,0,0,0,0,0
276,09,CIUDAD DE MEXICO,9002,AZCAPOTZALCO,0,0,0,0,0,0,0,0,0,0,0,0,0,0,0,0
277,09,CIUDAD DE MEXICO,9003,COYOACAN,0,0,0,0,0,0,0,0,0,0,0,0,0,0,0,0
278,09,CIUDAD DE MEXICO,9004,CUAJIMALPA DE MORELOS,22,3,19,0,0,0,0,0,0,0,0,0,22,3,19,0
279,09,CIUDAD DE MEXICO,9005,GUSTAVO A MADERO,2,2,0,0,0,0,0,0,0,0,0,0,2,2,0,0
280,09,CIUDAD DE MEXICO,9006,IZTACALCO,0,0,0,0,0,0,0,0,0,0,0,0,0,0,0,0
281,09,CIUDAD DE MEXICO,9007,IZTAPALAPA,29,27,2,0,0,0,0,0,0,0,0,0,29,27,2,0
282,09,CIUDAD DE MEXICO,9008,LA MAGDALENA CONTRERAS,0,0,0,0,0,0,0,0,0,0,0,0,0,0,0,0
283,09,CIUDAD DE MEXICO,9009,MILPA ALTA,0,0,0,0,0,0,0,0,0,0,0,0,0,0,0,0
284,09,CIUDAD DE MEXICO,9010,ALVARO OBREGON,1,1,0,0,0,0,0,0,0,0,0,0,1,1,0,0
285,09,CIUDAD DE MEXICO,9011,TLAHUAC,0,0,0,0,0,0,0,0,0,0,0,0,0,0,0,0
286,09,CIUDAD DE MEXICO,9012,TLALPAN,39,11,28,0,0,0,0,0,0,0,0,0,39,11,28,0
287,09,CIUDAD DE MEXICO,9013,XOCHIMILCO,0,0,0,0,0,0,0,0,0,0,0,0,0,0,0,0
288,09,CIUDAD DE MEXICO,9014,BENITO JUAREZ,4,0,4,0,0,0,0,0,0,0,0,0,4,0,4,0
289,09,CIUDAD DE MEXICO,9015,CUAUHTEMOC,0,0,0,0,0,0,0,0,0,0,0,0,0,0,0,0
290,09,CIUDAD DE MEXICO,9016,MIGUEL HIDALGO,1,0,1,0,0,0,0,0,0,0,0,0,1,0,1,0
291,09,CIUDAD DE MEXICO,9017,VENUSTIANO CARRANZA,6,2,4,0,0,0,0,0,0,0,0,0,6,2,4,0
292,10,DURANGO,10001,CANATLAN,0,0,0,0,0,0,0,0,0,0,0,0,0,0,0,0
293,10,DURANGO,10002,CANELAS,0,0,0,0,0,0,0,0,0,0,0,0,0,0,0,0
294,10,DURANGO,10003,CONETO DE COMONFORT,0,0,0,0,0,0,0,0,0,0,0,0,0,0,0,0
295,10,DURANGO,10004,CUENCAME,15,5,10,0,0,0,0,0,0,0,0,0,15,5,10,0
296,10,DURANGO,10005,DURANGO,58,27,31,0,0,0,0,0,0,0,0,0,58,27,31,0
297,10,DURANGO,10006,GENERAL SIMON BOLIVAR,0,0,0,0,0,0,0,0,0,0,0,0,0,0,0,0
298,10,DURANGO,10007,GOMEZ PALACIO,57,23,34,0,0,0,0,0,0,0,0,0,57,23,34,0
299,10,DURANGO,10008,GUADALUPE VICTORIA,0,0,0,0,0,0,0,0,0,0,0,0,0,0,0,0
300,10,DURANGO,10009,GUANACEVI,0,0,0,0,0,0,0,0,0,0,0,0,0,0,0,0
301,10,DURANGO,10010,HIDALGO,0,0,0,0,0,0,0,0,0,0,0,0,0,0,0,0
302,10,DURANGO,10011,INDE,0,0,0,0,0,0,0,0,0,0,0,0,0,0,0,0
303,10,DURANGO,10012,LERDO,51,8,43,0,0,0,0,0,0,0,0,0,51,8,43,0
304,10,DURANGO,10013,MAPIMI,28,5,23,0,0,0,0,0,0,0,0,0,28,5,23,0
305,10,DURANGO,10014,MEZQUITAL,0,0,0,0,0,0,0,0,0,0,0,0,0,0,0,0
306,10,DURANGO,10015,NAZAS,0,0,0,0,0,0,0,0,0,0,0,0,0,0,0,0
307,10,DURANGO,10016,NOMBRE DE DIOS,1,1,0,0,0,0,0,0,0,0,0,0,1,1,0,0
308,10,DURANGO,10017,OCAMPO,0,0,0,0,0,0,0,0,0,0,0,0,0,0,0,0
309,10,DURANGO,10018,EL ORO,0,0,0,0,0,0,0,0,0,0,0,0,0,0,0,0
310,10,DURANGO,10019,OTAEZ,0,0,0,0,0,0,0,0,0,0,0,0,0,0,0,0
311,10,DURANGO,10020,PANUCO DE CORONADO,0,0,0,0,0,0,0,0,0,0,0,0,0,0,0,0
312,10,DURANGO,10021,PEÑON BLANCO,0,0,0,0,0,0,0,0,0,0,0,0,0,0,0,0
313,10,DURANGO,10022,POANAS,0,0,0,0,0,0,0,0,0,0,0,0,0,0,0,0
314,10,DURANGO,10023,PUEBLO NUEVO,28,5,23,0,0,0,0,0,0,0,0,0,28,5,23,0
315,10,DURANGO,10024,RODEO,0,0,0,0,0,0,0,0,0,0,0,0,0,0,0,0
316,10,DURANGO,10025,SAN BERNARDO,0,0,0,0,0,0,0,0,0,0,0,0,0,0,0,0
317,10,DURANGO,10026,SAN DIMAS,0,0,0,0,0,0,0,0,0,0,0,0,0,0,0,0
318,10,DURANGO,10027,SAN JUAN DE GUADALUPE,0,0,0,0,0,0,0,0,0,0,0,0,0,0,0,0
319,10,DURANGO,10028,SAN JUAN DEL RIO,0,0,0,0,0,0,0,0,0,0,0,0,0,0,0,0
320,10,DURANGO,10029,SAN LUIS DEL CORDERO,0,0,0,0,0,0,0,0,0,0,0,0,0,0,0,0
321,10,DURANGO,10030,SAN PEDRO DEL GALLO,0,0,0,0,0,0,0,0,0,0,0,0,0,0,0,0
322,10,DURANGO,10031,SANTA CLARA,0,0,0,0,0,0,0,0,0,0,0,0,0,0,0,0
323,10,DURANGO,10032,SANTIAGO PAPASQUIARO,13,9,4,0,0,0,0,0,0,0,0,0,13,9,4,0
324,10,DURANGO,10033,SUCHIL,0,0,0,0,0,0,0,0,0,0,0,0,0,0,0,0
325,10,DURANGO,10034,TAMAZULA,1,1,0,0,0,0,0,0,0,0,0,0,1,1,0,0
326,10,DURANGO,10035,TEPEHUANES,0,0,0,0,0,0,0,0,0,0,0,0,0,0,0,0
327,10,DURANGO,10036,TLAHUALILO,0,0,0,0,0,0,0,0,0,0,0,0,0,0,0,0
328,10,DURANGO,10037,TOPIA,0,0,0,0,0,0,0,0,0,0,0,0,0,0,0,0
329,10,DURANGO,10038,VICENTE GUERRERO,0,0,0,0,0,0,0,0,0,0,0,0,0,0,0,0
330,10,DURANGO,10039,NUEVO IDEAL,1,0,1,0,0,0,0,0,0,0,0,0,1,0,1,0
331,11,GUANAJUATO,11001,ABASOLO,7,4,3,0,0,0,0,0,0,0,0,0,7,4,3,0
332,11,GUANAJUATO,11002,ACAMBARO,17,12,5,0,0,0,0,0,0,0,0,0,17,12,5,0
333,11,GUANAJUATO,11003,SAN MIGUEL DE ALLENDE,7,6,1,0,0,0,0,0,0,0,0,0,7,6,1,0
334,11,GUANAJUATO,11004,APASEO EL ALTO,33,24,9,0,0,0,0,0,0,0,0,0,33,24,9,0
335,11,GUANAJUATO,11005,APASEO EL GRANDE,62,47,15,0,0,0,0,0,0,0,0,0,62,47,15,0
336,11,GUANAJUATO,11006,ATARJEA,0,0,0,0,0,0,0,0,0,0,0,0,0,0,0,0
337,11,GUANAJUATO,11007,CELAYA,150,102,48,0,0,0,0,0,0,0,0,0,150,102,48,0
338,11,GUANAJUATO,11008,MANUEL DOBLADO,3,2,1,0,0,0,0,0,0,0,0,0,3,2,1,0
339,11,GUANAJUATO,11009,COMONFORT,0,0,0,0,0,0,0,0,0,0,0,0,0,0,0,0
340,11,GUANAJUATO,11010,CORONEO,4,3,1,0,0,0,0,0,0,0,0,0,4,3,1,0
341,11,GUANAJUATO,11011,CORTAZAR,18,11,7,0,0,0,0,0,0,0,0,0,18,11,7,0
342,11,GUANAJUATO,11012,CUERAMARO,4,4,0,0,0,0,0,0,0,0,0,0,4,4,0,0
343,11,GUANAJUATO,11013,DOCTOR MORA,0,0,0,0,0,0,0,0,0,0,0,0,0,0,0,0
344,11,GUANAJUATO,11014,DOLORES HIDALGO CUNA DE LA INDEPENDENCIA NACIONAL,25,19,6,0,0,0,0,0,0,0,0,0,25,19,6,0
345,11,GUANAJUATO,11015,GUANAJUATO,9,4,5,0,0,0,0,0,0,0,0,0,9,4,5,0
346,11,GUANAJUATO,11016,HUANIMARO,0,0,0,0,0,0,0,0,0,0,0,0,0,0,0,0
347,11,GUANAJUATO,11017,IRAPUATO,131,59,72,0,0,0,0,0,0,0,0,0,131,59,72,0
348,11,GUANAJUATO,11018,JARAL DEL PROGRESO,1,1,0,0,0,0,0,0,0,0,0,0,1,1,0,0
349,11,GUANAJUATO,11019,JERECUARO,4,2,2,0,0,0,0,0,0,0,0,0,4,2,2,0
350,11,GUANAJUATO,11020,LEON,211,123,88,0,0,0,0,0,0,0,0,0,211,123,88,0
351,11,GUANAJUATO,11021,MOROLEON,4,3,1,0,0,0,0,0,0,0,0,0,4,3,1,0
352,11,GUANAJUATO,11022,OCAMPO,9,4,5,0,0,0,0,0,0,0,0,0,9,4,5,0
353,11,GUANAJUATO,11023,PENJAMO,6,1,5,0,0,0,0,0,0,0,0,0,6,1,5,0
354,11,GUANAJUATO,11024,PUEBLO NUEVO,4,4,0,0,0,0,0,0,0,0,0,0,4,4,0,0
355,11,GUANAJUATO,11025,PURISIMA DEL RINCON,2,1,1,0,0,0,0,0,0,0,0,0,2,1,1,0
356,11,GUANAJUATO,11026,ROMITA,2,2,0,0,0,0,0,0,0,0,0,0,2,2,0,0
357,11,GUANAJUATO,11027,SALAMANCA,253,148,105,0,0,0,0,0,0,0,0,0,253,148,105,0
358,11,GUANAJUATO,11028,SALVATIERRA,5,5,0,0,0,0,0,0,0,0,0,0,5,5,0,0
359,11,GUANAJUATO,11029,SAN DIEGO DE LA UNION,27,21,6,0,0,0,0,0,0,0,0,0,27,21,6,0
360,11,GUANAJUATO,11030,SAN FELIPE,9,5,4,0,0,0,0,0,0,0,0,0,9,5,4,0
361,11,GUANAJUATO,11031,SAN FRANCISCO DEL RINCON,14,8,6,0,0,0,0,0,0,0,0,0,14,8,6,0
362,11,GUANAJUATO,11032,SAN JOSE ITURBIDE,32,20,12,0,0,0,0,0,0,0,0,0,32,20,12,0
363,11,GUANAJUATO,11033,SAN LUIS DE LA PAZ,49,30,19,0,0,0,0,0,0,0,0,0,49,30,19,0
364,11,GUANAJUATO,11034,SANTA CATARINA,1,0,1,0,0,0,0,0,0,0,0,0,1,0,1,0
365,11,GUANAJUATO,11035,SANTA CRUZ DE JUVENTINO ROSAS,70,58,12,0,0,0,0,0,0,0,0,0,70,58,12,0
366,11,GUANAJUATO,11036,SANTIAGO MARAVATIO,0,0,0,0,0,0,0,0,0,0,0,0,0,0,0,0
367,11,GUANAJUATO,11037,SILAO DE LA VICTORIA,18,10,8,0,0,0,0,0,0,0,0,0,18,10,8,0
368,11,GUANAJUATO,11038,TARANDACUAO,0,0,0,0,0,0,0,0,0,0,0,0,0,0,0,0
369,11,GUANAJUATO,11039,TARIMORO,5,5,0,0,0,0,0,0,0,0,0,0,5,5,0,0
370,11,GUANAJUATO,11040,TIERRA BLANCA,0,0,0,0,0,0,0,0,0,0,0,0,0,0,0,0
371,11,GUANAJUATO,11041,URIANGATO,18,10,8,0,0,0,0,0,0,0,0,0,18,10,8,0
372,11,GUANAJUATO,11042,VALLE DE SANTIAGO,8,6,2,0,0,0,0,0,0,0,0,0,8,6,2,0
373,11,GUANAJUATO,11043,VICTORIA,0,0,0,0,0,0,0,0,0,0,0,0,0,0,0,0
374,11,GUANAJUATO,11044,VILLAGRAN,22,14,8,0,0,0,0,0,0,0,0,0,22,14,8,0
375,11,GUANAJUATO,11045,XICHU,0,0,0,0,0,0,0,0,0,0,0,0,0,0,0,0
376,11,GUANAJUATO,11046,YURIRIA,15,11,4,0,0,0,0,0,0,0,0,0,15,11,4,0
377,12,GUERRERO,12001,ACAPULCO DE JUAREZ,15,7,8,0,0,0,0,0,0,0,0,0,15,7,8,0
378,12,GUERRERO,12002,AHUACUOTZINGO,0,0,0,0,0,0,0,0,0,0,0,0,0,0,0,0
379,12,GUERRERO,12003,AJUCHITLAN DEL PROGRESO,1,1,0,0,0,0,0,0,0,0,0,0,1,1,0,0
380,12,GUERRERO,12004,ALCOZAUCA DE GUERRERO,0,0,0,0,0,0,0,0,0,0,0,0,0,0,0,0
381,12,GUERRERO,12005,ALPOYECA,0,0,0,0,0,0,0,0,0,0,0,0,0,0,0,0
382,12,GUERRERO,12006,APAXTLA,0,0,0,0,0,0,0,0,0,0,0,0,0,0,0,0
383,12,GUERRERO,12007,ARCELIA,0,0,0,0,0,0,0,0,0,0,0,0,0,0,0,0
384,12,GUERRERO,12008,ATENANGO DEL RIO,0,0,0,0,0,0,0,0,0,0,0,0,0,0,0,0
385,12,GUERRERO,12009,ATLAMAJALCINGO DEL MONTE,0,0,0,0,0,0,0,0,0,0,0,0,0,0,0,0
386,12,GUERRERO,12010,ATLIXTAC,0,0,0,0,0,0,0,0,0,0,0,0,0,0,0,0
387,12,GUERRERO,12011,ATOYAC DE ALVAREZ,0,0,0,0,0,0,0,0,0,0,0,0,0,0,0,0
388,12,GUERRERO,12012,AYUTLA DE LOS LIBRES,1,1,0,0,0,0,0,0,0,0,0,0,1,1,0,0
389,12,GUERRERO,12013,AZOYU,0,0,0,0,0,0,0,0,0,0,0,0,0,0,0,0
390,12,GUERRERO,12014,BENITO JUAREZ,0,0,0,0,0,0,0,0,0,0,0,0,0,0,0,0
391,12,GUERRERO,12015,BUENAVISTA DE CUELLAR,1,1,0,0,0,0,0,0,0,0,0,0,1,1,0,0
392,12,GUERRERO,12016,COAHUAYUTLA DE JOSE MARIA IZAZAGA,0,0,0,0,0,0,0,0,0,0,0,0,0,0,0,0
393,12,GUERRERO,12017,COCULA,0,0,0,0,0,0,0,0,0,0,0,0,0,0,0,0
394,12,GUERRERO,12018,COPALA,0,0,0,0,0,0,0,0,0,0,0,0,0,0,0,0
395,12,GUERRERO,12019,COPALILLO,0,0,0,0,0,0,0,0,0,0,0,0,0,0,0,0
396,12,GUERRERO,12020,COPANATOYAC,0,0,0,0,0,0,0,0,0,0,0,0,0,0,0,0
397,12,GUERRERO,12021,COYUCA DE BENITEZ,0,0,0,0,0,0,0,0,0,0,0,0,0,0,0,0
398,12,GUERRERO,12022,COYUCA DE CATALAN,0,0,0,0,0,0,0,0,0,0,0,0,0,0,0,0
399,12,GUERRERO,12023,CUAJINICUILAPA,4,0,4,0,0,0,0,0,0,0,0,0,4,0,4,0
400,12,GUERRERO,12024,CUALAC,0,0,0,0,0,0,0,0,0,0,0,0,0,0,0,0
401,12,GUERRERO,12025,CUAUTEPEC,0,0,0,0,0,0,0,0,0,0,0,0,0,0,0,0
402,12,GUERRERO,12026,CUETZALA DEL PROGRESO,0,0,0,0,0,0,0,0,0,0,0,0,0,0,0,0
403,12,GUERRERO,12027,CUTZAMALA DE PINZON,1,0,1,0,0,0,0,0,0,0,0,0,1,0,1,0
404,12,GUERRERO,12028,CHILAPA DE ALVAREZ,0,0,0,0,0,0,0,0,0,0,0,0,0,0,0,0
405,12,GUERRERO,12029,CHILPANCINGO DE LOS BRAVO,19,11,8,0,0,0,0,0,0,0,0,0,19,11,8,0
406,12,GUERRERO,12030,FLORENCIO VILLARREAL,1,0,1,0,0,0,0,0,0,0,0,0,1,0,1,0
407,12,GUERRERO,12031,GENERAL CANUTO A NERI,0,0,0,0,0,0,0,0,0,0,0,0,0,0,0,0
408,12,GUERRERO,12032,GENERAL HELIODORO CASTILLO,0,0,0,0,0,0,0,0,0,0,0,0,0,0,0,0
409,12,GUERRERO,12033,HUAMUXTITLAN,1,1,0,0,0,0,0,0,0,0,0,0,1,1,0,0
410,12,GUERRERO,12034,HUITZUCO DE LOS FIGUEROA,14,8,6,0,0,0,0,0,0,0,0,0,14,8,6,0
411,12,GUERRERO,12035,IGUALA DE LA INDEPENDENCIA,5,4,1,0,0,0,0,0,0,0,0,0,5,4,1,0
412,12,GUERRERO,12036,IGUALAPA,0,0,0,0,0,0,0,0,0,0,0,0,0,0,0,0
413,12,GUERRERO,12037,IXCATEOPAN DE CUAUHTEMOC,0,0,0,0,0,0,0,0,0,0,0,0,0,0,0,0
414,12,GUERRERO,12038,ZIHUATANEJO DE AZUETA,1,0,1,0,0,0,0,0,0,0,0,0,1,0,1,0
415,12,GUERRERO,12039,JUAN R ESCUDERO,2,1,1,0,0,0,0,0,0,0,0,0,2,1,1,0
416,12,GUERRERO,12040,LEONARDO BRAVO,0,0,0,0,0,0,0,0,0,0,0,0,0,0,0,0
417,12,GUERRERO,12041,MALINALTEPEC,0,0,0,0,0,0,0,0,0,0,0,0,0,0,0,0
418,12,GUERRERO,12042,MARTIR DE CUILAPAN,1,1,0,0,0,0,0,0,0,0,0,0,1,1,0,0
419,12,GUERRERO,12043,METLATONOC,0,0,0,0,0,0,0,0,0,0,0,0,0,0,0,0
420,12,GUERRERO,12044,MOCHITLAN,0,0,0,0,0,0,0,0,0,0,0,0,0,0,0,0
421,12,GUERRERO,12045,OLINALA,0,0,0,0,0,0,0,0,0,0,0,0,0,0,0,0
422,12,GUERRERO,12046,OMETEPEC,0,0,0,0,0,0,0,0,0,0,0,0,0,0,0,0
423,12,GUERRERO,12047,PEDRO ASCENCIO ALQUISIRAS,0,0,0,0,0,0,0,0,0,0,0,0,0,0,0,0
424,12,GUERRERO,12048,PETATLAN,1,0,1,0,0,0,0,0,0,0,0,0,1,0,1,0
425,12,GUERRERO,12049,PILCAYA,2,1,1,0,0,0,0,0,0,0,0,0,2,1,1,0
426,12,GUERRERO,12050,PUNGARABATO,0,0,0,0,0,0,0,0,0,0,0,0,0,0,0,0
427,12,GUERRERO,12051,QUECHULTENANGO,0,0,0,0,0,0,0,0,0,0,0,0,0,0,0,0
428,12,GUERRERO,12052,SAN LUIS ACATLAN,0,0,0,0,0,0,0,0,0,0,0,0,0,0,0,0
429,12,GUERRERO,12053,SAN MARCOS,0,0,0,0,0,0,0,0,0,0,0,0,0,0,0,0
430,12,GUERRERO,12054,SAN MIGUEL TOTOLAPAN,0,0,0,0,0,0,0,0,0,0,0,0,0,0,0,0
431,12,GUERRERO,12055,TAXCO DE ALARCON,15,8,7,0,0,0,0,0,0,0,0,0,15,8,7,0
432,12,GUERRERO,12056,TECOANAPA,0,0,0,0,0,0,0,0,0,0,0,0,0,0,0,0
433,12,GUERRERO,12057,TECPAN DE GALEANA,6,5,1,0,0,0,0,0,0,0,0,0,6,5,1,0
434,12,GUERRERO,12058,TELOLOAPAN,0,0,0,0,0,0,0,0,0,0,0,0,0,0,0,0
435,12,GUERRERO,12059,TEPECOACUILCO DE TRUJANO,0,0,0,0,0,0,0,0,0,0,0,0,0,0,0,0
436,12,GUERRERO,12060,TETIPAC,0,0,0,0,0,0,0,0,0,0,0,0,0,0,0,0
437,12,GUERRERO,12061,TIXTLA DE GUERRERO,0,0,0,0,0,0,0,0,0,0,0,0,0,0,0,0
438,12,GUERRERO,12062,TLACOACHISTLAHUACA,0,0,0,0,0,0,0,0,0,0,0,0,0,0,0,0
439,12,GUERRERO,12063,TLACOAPA,0,0,0,0,0,0,0,0,0,0,0,0,0,0,0,0
440,12,GUERRERO,12064,TLALCHAPA,0,0,0,0,0,0,0,0,0,0,0,0,0,0,0,0
441,12,GUERRERO,12065,TLALIXTAQUILLA DE MALDONADO,0,0,0,0,0,0,0,0,0,0,0,0,0,0,0,0
442,12,GUERRERO,12066,TLAPA DE COMONFORT,0,0,0,0,0,0,0,0,0,0,0,0,0,0,0,0
443,12,GUERRERO,12067,TLAPEHUALA,0,0,0,0,0,0,0,0,0,0,0,0,0,0,0,0
444,12,GUERRERO,12068,LA UNION DE ISIDORO MONTES DE OCA,6,1,5,0,0,0,0,0,0,0,0,0,6,1,5,0
445,12,GUERRERO,12069,XALPATLAHUAC,0,0,0,0,0,0,0,0,0,0,0,0,0,0,0,0
446,12,GUERRERO,12070,XOCHIHUEHUETLAN,0,0,0,0,0,0,0,0,0,0,0,0,0,0,0,0
447,12,GUERRERO,12071,XOCHISTLAHUACA,0,0,0,0,0,0,0,0,0,0,0,0,0,0,0,0
448,12,GUERRERO,12072,ZAPOTITLAN TABLAS,0,0,0,0,0,0,0,0,0,0,0,0,0,0,0,0
449,12,GUERRERO,12073,ZIRANDARO,0,0,0,0,0,0,0,0,0,0,0,0,0,0,0,0
450,12,GUERRERO,12074,ZITLALA,0,0,0,0,0,0,0,0,0,0,0,0,0,0,0,0
451,12,GUERRERO,12075,EDUARDO NERI,12,9,3,0,0,0,0,0,0,0,0,0,12,9,3,0
452,12,GUERRERO,12076,ACATEPEC,0,0,0,0,0,0,0,0,0,0,0,0,0,0,0,0
453,12,GUERRERO,12077,MARQUELIA,0,0,0,0,0,0,0,0,0,0,0,0,0,0,0,0
454,12,GUERRERO,12078,COCHOAPA EL GRANDE,0,0,0,0,0,0,0,0,0,0,0,0,0,0,0,0
455,12,GUERRERO,12079,JOSE JOAQUIN DE HERRERA,0,0,0,0,0,0,0,0,0,0,0,0,0,0,0,0
456,12,GUERRERO,12080,JUCHITAN,0,0,0,0,0,0,0,0,0,0,0,0,0,0,0,0
457,12,GUERRERO,12081,ILIATENCO,0,0,0,0,0,0,0,0,0,0,0,0,0,0,0,0
458,13,HIDALGO,13001,ACATLAN,0,0,0,0,0,0,0,0,0,0,0,0,0,0,0,0
459,13,HIDALGO,13002,ACAXOCHITLAN,15,9,6,0,0,0,0,0,0,0,0,0,15,9,6,0
460,13,HIDALGO,13003,ACTOPAN,0,0,0,0,0,0,0,0,0,0,0,0,0,0,0,0
461,13,HIDALGO,13004,AGUA BLANCA DE ITURBIDE,0,0,0,0,0,0,0,0,0,0,0,0,0,0,0,0
462,13,HIDALGO,13005,AJACUBA,4,1,3,0,0,0,0,0,0,0,0,0,4,1,3,0
463,13,HIDALGO,13006,ALFAJAYUCAN,1,1,0,0,0,0,0,0,0,0,0,0,1,1,0,0
464,13,HIDALGO,13007,ALMOLOYA,0,0,0,0,0,0,0,0,0,0,0,0,0,0,0,0
465,13,HIDALGO,13008,APAN,2,0,2,0,0,0,0,0,0,0,0,0,2,0,2,0
466,13,HIDALGO,13009,EL ARENAL,2,2,0,0,0,0,0,0,0,0,0,0,2,2,0,0
467,13,HIDALGO,13010,ATITALAQUIA,12,6,6,0,0,0,0,0,0,0,0,0,12,6,6,0
468,13,HIDALGO,13011,ATLAPEXCO,0,0,0,0,0,0,0,0,0,0,0,0,0,0,0,0
469,13,HIDALGO,13012,ATOTONILCO EL GRANDE,3,2,1,0,0,0,0,0,0,0,0,0,3,2,1,0
470,13,HIDALGO,13013,ATOTONILCO DE TULA,32,13,19,0,0,0,0,0,0,0,0,0,32,13,19,0
471,13,HIDALGO,13014,CALNALI,0,0,0,0,0,0,0,0,0,0,0,0,0,0,0,0
472,13,HIDALGO,13015,CARDONAL,0,0,0,0,0,0,0,0,0,0,0,0,0,0,0,0
473,13,HIDALGO,13016,CUAUTEPEC DE HINOJOSA,1,0,1,0,0,0,0,0,0,0,0,0,1,0,1,0
474,13,HIDALGO,13017,CHAPANTONGO,0,0,0,0,0,0,0,0,0,0,0,0,0,0,0,0
475,13,HIDALGO,13018,CHAPULHUACAN,0,0,0,0,0,0,0,0,0,0,0,0,0,0,0,0
476,13,HIDALGO,13019,CHILCUAUTLA,0,0,0,0,0,0,0,0,0,0,0,0,0,0,0,0
477,13,HIDALGO,13020,ELOXOCHITLAN,0,0,0,0,0,0,0,0,0,0,0,0,0,0,0,0
478,13,HIDALGO,13021,EMILIANO ZAPATA,9,2,7,0,0,0,0,0,0,0,0,0,9,2,7,0
479,13,HIDALGO,13022,EPAZOYUCAN,3,1,2,0,0,0,0,0,0,0,0,0,3,1,2,0
480,13,HIDALGO,13023,FRANCISCO I MADERO,0,0,0,0,0,0,0,0,0,0,0,0,0,0,0,0
481,13,HIDALGO,13024,HUASCA DE OCAMPO,0,0,0,0,0,0,0,0,0,0,0,0,0,0,0,0
482,13,HIDALGO,13025,HUAUTLA,0,0,0,0,0,0,0,0,0,0,0,0,0,0,0,0
483,13,HIDALGO,13026,HUAZALINGO,0,0,0,0,0,0,0,0,0,0,0,0,0,0,0,0
484,13,HIDALGO,13027,HUEHUETLA,0,0,0,0,0,0,0,0,0,0,0,0,0,0,0,0
485,13,HIDALGO,13028,HUEJUTLA DE REYES,2,2,0,0,0,0,0,0,0,0,0,0,2,2,0,0
486,13,HIDALGO,13029,HUICHAPAN,19,15,4,0,0,0,0,0,0,0,0,0,19,15,4,0
487,13,HIDALGO,13030,IXMIQUILPAN,0,0,0,0,0,0,0,0,0,0,0,0,0,0,0,0
488,13,HIDALGO,13031,JACALA DE LEDEZMA,1,1,0,0,0,0,0,0,0,0,0,0,1,1,0,0
489,13,HIDALGO,13032,JALTOCAN,0,0,0,0,0,0,0,0,0,0,0,0,0,0,0,0
490,13,HIDALGO,13033,JUAREZ HIDALGO,0,0,0,0,0,0,0,0,0,0,0,0,0,0,0,0
491,13,HIDALGO,13034,LOLOTLA,0,0,0,0,0,0,0,0,0,0,0,0,0,0,0,0
492,13,HIDALGO,13035,METEPEC,0,0,0,0,0,0,0,0,0,0,0,0,0,0,0,0
493,13,HIDALGO,13036,SAN AGUSTIN METZQUITITLAN,2,1,1,0,0,0,0,0,0,0,0,0,2,1,1,0
494,13,HIDALGO,13037,METZTITLAN,0,0,0,0,0,0,0,0,0,0,0,0,0,0,0,0
495,13,HIDALGO,13038,MINERAL DEL CHICO,0,0,0,0,0,0,0,0,0,0,0,0,0,0,0,0
496,13,HIDALGO,13039,MINERAL DEL MONTE,0,0,0,0,0,0,0,0,0,0,0,0,0,0,0,0
497,13,HIDALGO,13040,LA MISION,0,0,0,0,0,0,0,0,0,0,0,0,0,0,0,0
498,13,HIDALGO,13041,MIXQUIAHUALA DE JUAREZ,0,0,0,0,0,0,0,0,0,0,0,0,0,0,0,0
499,13,HIDALGO,13042,MOLANGO DE ESCAMILLA,0,0,0,0,0,0,0,0,0,0,0,0,0,0,0,0
500,13,HIDALGO,13043,NICOLAS FLORES,0,0,0,0,0,0,0,0,0,0,0,0,0,0,0,0
501,13,HIDALGO,13044,NOPALA DE VILLAGRAN,0,0,0,0,0,0,0,0,0,0,0,0,0,0,0,0
502,13,HIDALGO,13045,OMITLAN DE JUAREZ,4,1,3,0,0,0,0,0,0,0,0,0,4,1,3,0
503,13,HIDALGO,13046,SAN FELIPE ORIZATLAN,0,0,0,0,0,0,0,0,0,0,0,0,0,0,0,0
504,13,HIDALGO,13047,PACULA,0,0,0,0,0,0,0,0,0,0,0,0,0,0,0,0
505,13,HIDALGO,13048,PACHUCA DE SOTO,5,2,3,0,0,0,0,0,0,0,0,0,5,2,3,0
506,13,HIDALGO,13049,PISAFLORES,0,0,0,0,0,0,0,0,0,0,0,0,0,0,0,0
507,13,HIDALGO,13050,PROGRESO DE OBREGON,0,0,0,0,0,0,0,0,0,0,0,0,0,0,0,0
508,13,HIDALGO,13051,MINERAL DE LA REFORMA,9,4,5,0,0,0,0,0,0,0,0,0,9,4,5,0
509,13,HIDALGO,13052,SAN AGUSTIN TLAXIACA,5,0,5,0,0,0,0,0,0,0,0,0,5,0,5,0
510,13,HIDALGO,13053,SAN BARTOLO TUTOTEPEC,0,0,0,0,0,0,0,0,0,0,0,0,0,0,0,0
511,13,HIDALGO,13054,SAN SALVADOR,0,0,0,0,0,0,0,0,0,0,0,0,0,0,0,0
512,13,HIDALGO,13055,SANTIAGO DE ANAYA,0,0,0,0,0,0,0,0,0,0,0,0,0,0,0,0
513,13,HIDALGO,13056,SANTIAGO TULANTEPEC DE LUGO GUERRERO,2,0,2,0,0,0,0,0,0,0,0,0,2,0,2,0
514,13,HIDALGO,13057,SINGUILUCAN,14,6,8,0,0,0,0,0,0,0,0,0,14,6,8,0
515,13,HIDALGO,13058,TASQUILLO,2,0,2,0,0,0,0,0,0,0,0,0,2,0,2,0
516,13,HIDALGO,13059,TECOZAUTLA,0,0,0,0,0,0,0,0,0,0,0,0,0,0,0,0
517,13,HIDALGO,13060,TENANGO DE DORIA,0,0,0,0,0,0,0,0,0,0,0,0,0,0,0,0
518,13,HIDALGO,13061,TEPEAPULCO,2,1,1,0,0,0,0,0,0,0,0,0,2,1,1,0
519,13,HIDALGO,13062,TEPEHUACAN DE GUERRERO,0,0,0,0,0,0,0,0,0,0,0,0,0,0,0,0
520,13,HIDALGO,13063,TEPEJI DEL RIO DE OCAMPO,0,0,0,0,0,0,0,0,0,0,0,0,0,0,0,0
521,13,HIDALGO,13064,TEPETITLAN,1,1,0,0,0,0,0,0,0,0,0,0,1,1,0,0
522,13,HIDALGO,13065,TETEPANGO,0,0,0,0,0,0,0,0,0,0,0,0,0,0,0,0
523,13,HIDALGO,13066,VILLA DE TEZONTEPEC,1,1,0,0,0,0,0,0,0,0,0,0,1,1,0,0
524,13,HIDALGO,13067,TEZONTEPEC DE ALDAMA,0,0,0,0,0,0,0,0,0,0,0,0,0,0,0,0
525,13,HIDALGO,13068,TIANGUISTENGO,0,0,0,0,0,0,0,0,0,0,0,0,0,0,0,0
526,13,HIDALGO,13069,TIZAYUCA,34,18,16,0,0,0,0,0,0,0,0,0,34,18,16,0
527,13,HIDALGO,13070,TLAHUELILPAN,1,1,0,0,0,0,0,0,0,0,0,0,1,1,0,0
528,13,HIDALGO,13071,TLAHUILTEPA,0,0,0,0,0,0,0,0,0,0,0,0,0,0,0,0
529,13,HIDALGO,13072,TLANALAPA,4,1,3,0,0,0,0,0,0,0,0,0,4,1,3,0
530,13,HIDALGO,13073,TLANCHINOL,0,0,0,0,0,0,0,0,0,0,0,0,0,0,0,0
531,13,HIDALGO,13074,TLAXCOAPAN,6,4,2,0,0,0,0,0,0,0,0,0,6,4,2,0
532,13,HIDALGO,13075,TOLCAYUCA,42,18,24,0,0,0,0,0,0,0,0,0,42,18,24,0
533,13,HIDALGO,13076,TULA DE ALLENDE,74,38,36,0,0,0,0,0,0,0,0,0,74,38,36,0
534,13,HIDALGO,13077,TULANCINGO DE BRAVO,33,14,19,0,0,0,0,0,0,0,0,0,33,14,19,0
535,13,HIDALGO,13078,XOCHIATIPAN,0,0,0,0,0,0,0,0,0,0,0,0,0,0,0,0
536,13,HIDALGO,13079,XOCHICOATLAN,0,0,0,0,0,0,0,0,0,0,0,0,0,0,0,0
537,13,HIDALGO,13080,YAHUALICA,0,0,0,0,0,0,0,0,0,0,0,0,0,0,0,0
538,13,HIDALGO,13081,ZACUALTIPAN DE ANGELES,10,2,8,0,0,0,0,0,0,0,0,0,10,2,8,0
539,13,HIDALGO,13082,ZAPOTLAN DE JUAREZ,5,1,4,0,0,0,0,0,0,0,0,0,5,1,4,0
540,13,HIDALGO,13083,ZEMPOALA,25,12,13,0,0,0,0,0,0,0,0,0,25,12,13,0
541,13,HIDALGO,13084,ZIMAPAN,0,0,0,0,0,0,0,0,0,0,0,0,0,0,0,0
542,14,JALISCO,14001,ACATIC,1,1,0,0,0,0,0,0,0,0,0,0,1,1,0,0
543,14,JALISCO,14002,ACATLAN DE JUAREZ,46,26,20,0,0,0,0,0,0,0,0,0,46,26,20,0
544,14,JALISCO,14003,AHUALULCO DE MERCADO,2,1,1,0,0,0,0,0,0,0,0,0,2,1,1,0
545,14,JALISCO,14004,AMACUECA,0,0,0,0,0,0,0,0,0,0,0,0,0,0,0,0
546,14,JALISCO,14005,AMATITAN,7,4,3,0,0,0,0,0,0,0,0,0,7,4,3,0
547,14,JALISCO,14006,AMECA,4,1,3,0,0,0,0,0,0,0,0,0,4,1,3,0
548,14,JALISCO,14007,SAN JUANITO DE ESCOBEDO,0,0,0,0,0,0,0,0,0,0,0,0,0,0,0,0
549,14,JALISCO,14008,ARANDAS,0,0,0,0,0,0,0,0,0,0,0,0,0,0,0,0
550,14,JALISCO,14009,EL ARENAL,113,39,74,0,0,0,0,0,0,0,0,0,113,39,74,0
551,14,JALISCO,14010,ATEMAJAC DE BRIZUELA,0,0,0,0,0,0,0,0,0,0,0,0,0,0,0,0
552,14,JALISCO,14011,ATENGO,0,0,0,0,0,0,0,0,0,0,0,0,0,0,0,0
553,14,JALISCO,14012,ATENGUILLO,0,0,0,0,0,0,0,0,0,0,0,0,0,0,0,0
554,14,JALISCO,14013,ATOTONILCO EL ALTO,5,4,1,0,0,0,0,0,0,0,0,0,5,4,1,0
555,14,JALISCO,14014,ATOYAC,0,0,0,0,0,0,0,0,0,0,0,0,0,0,0,0
556,14,JALISCO,14015,AUTLAN DE NAVARRO,23,7,16,0,0,0,0,0,0,0,0,0,23,7,16,0
557,14,JALISCO,14016,AYOTLAN,1,1,0,0,0,0,0,0,0,0,0,0,1,1,0,0
558,14,JALISCO,14017,AYUTLA,0,0,0,0,0,0,0,0,0,0,0,0,0,0,0,0
559,14,JALISCO,14018,LA BARCA,6,4,2,0,0,0,0,0,0,0,0,0,6,4,2,0
560,14,JALISCO,14019,BOLAÑOS,0,0,0,0,0,0,0,0,0,0,0,0,0,0,0,0
561,14,JALISCO,14020,CABO CORRIENTES,0,0,0,0,0,0,0,0,0,0,0,0,0,0,0,0
562,14,JALISCO,14021,CASIMIRO CASTILLO,1,1,0,0,0,0,0,0,0,0,0,0,1,1,0,0
563,14,JALISCO,14022,CIHUATLAN,8,0,8,0,0,0,0,0,0,0,0,0,8,0,8,0
564,14,JALISCO,14023,ZAPOTLAN EL GRANDE,22,10,12,0,0,0,0,0,0,0,0,0,22,10,12,0
565,14,JALISCO,14024,COCULA,1,0,1,0,0,0,0,0,0,0,0,0,1,0,1,0
566,14,JALISCO,14025,COLOTLAN,0,0,0,0,0,0,0,0,0,0,0,0,0,0,0,0
567,14,JALISCO,14026,CONCEPCION DE BUENOS AIRES,0,0,0,0,0,0,0,0,0,0,0,0,0,0,0,0
568,14,JALISCO,14027,CUAUTITLAN DE GARCIA BARRAGAN,0,0,0,0,0,0,0,0,0,0,0,0,0,0,0,0
569,14,JALISCO,14028,CUAUTLA,0,0,0,0,0,0,0,0,0,0,0,0,0,0,0,0
570,14,JALISCO,14029,CUQUIO,0,0,0,0,0,0,0,0,0,0,0,0,0,0,0,0
571,14,JALISCO,14030,CHAPALA,1,0,1,0,0,0,0,0,0,0,0,0,1,0,1,0
572,14,JALISCO,14031,CHIMALTITAN,0,0,0,0,0,0,0,0,0,0,0,0,0,0,0,0
573,14,JALISCO,14032,CHIQUILISTLAN,0,0,0,0,0,0,0,0,0,0,0,0,0,0,0,0
574,14,JALISCO,14033,DEGOLLADO,2,0,2,0,0,0,0,0,0,0,0,0,2,0,2,0
575,14,JALISCO,14034,EJUTLA,0,0,0,0,0,0,0,0,0,0,0,0,0,0,0,0
576,14,JALISCO,14035,ENCARNACION DE DIAZ,10,8,2,0,0,0,0,0,0,0,0,0,10,8,2,0
577,14,JALISCO,14036,ETZATLAN,3,3,0,0,0,0,0,0,0,0,0,0,3,3,0,0
578,14,JALISCO,14037,EL GRULLO,0,0,0,0,0,0,0,0,0,0,0,0,0,0,0,0
579,14,JALISCO,14038,GUACHINANGO,0,0,0,0,0,0,0,0,0,0,0,0,0,0,0,0
580,14,JALISCO,14039,GUADALAJARA,10,5,5,0,0,0,0,0,0,0,0,0,10,5,5,0
581,14,JALISCO,14040,HOSTOTIPAQUILLO,21,7,14,0,0,0,0,0,0,0,0,0,21,7,14,0
582,14,JALISCO,14041,HUEJUCAR,1,1,0,0,0,0,0,0,0,0,0,0,1,1,0,0
583,14,JALISCO,14042,HUEJUQUILLA EL ALTO,0,0,0,0,0,0,0,0,0,0,0,0,0,0,0,0
584,14,JALISCO,14043,LA HUERTA,3,1,2,0,0,0,0,0,0,0,0,0,3,1,2,0
585,14,JALISCO,14044,IXTLAHUACAN DE LOS MEMBRILLOS,69,46,23,0,0,0,0,0,0,0,0,0,69,46,23,0
586,14,JALISCO,14045,IXTLAHUACAN DEL RIO,5,4,1,0,0,0,0,0,0,0,0,0,5,4,1,0
587,14,JALISCO,14046,JALOSTOTITLAN,9,2,7,0,0,0,0,0,0,0,0,0,9,2,7,0
588,14,JALISCO,14047,JAMAY,9,2,7,0,0,0,0,0,0,0,0,0,9,2,7,0
589,14,JALISCO,14048,JESUS MARIA,0,0,0,0,0,0,0,0,0,0,0,0,0,0,0,0
590,14,JALISCO,14049,JILOTLAN DE LOS DOLORES,0,0,0,0,0,0,0,0,0,0,0,0,0,0,0,0
591,14,JALISCO,14050,JOCOTEPEC,4,2,2,0,0,0,0,0,0,0,0,0,4,2,2,0
592,14,JALISCO,14051,JUANACATLAN,1,1,0,0,0,0,0,0,0,0,0,0,1,1,0,0
593,14,JALISCO,14052,JUCHITLAN,0,0,0,0,0,0,0,0,0,0,0,0,0,0,0,0
594,14,JALISCO,14053,LAGOS DE MORENO,141,72,69,0,0,0,0,0,0,0,0,0,141,72,69,0
595,14,JALISCO,14054,EL LIMON,0,0,0,0,0,0,0,0,0,0,0,0,0,0,0,0
596,14,JALISCO,14055,MAGDALENA,51,20,31,0,0,0,0,0,0,0,0,0,51,20,31,0
597,14,JALISCO,14056,SANTA MARIA DEL ORO,0,0,0,0,0,0,0,0,0,0,0,0,0,0,0,0
598,14,JALISCO,14057,LA MANZANILLA DE LA PAZ,0,0,0,0,0,0,0,0,0,0,0,0,0,0,0,0
599,14,JALISCO,14058,MASCOTA,0,0,0,0,0,0,0,0,0,0,0,0,0,0,0,0
600,14,JALISCO,14059,MAZAMITLA,7,7,0,0,0,0,0,0,0,0,0,0,7,7,0,0
601,14,JALISCO,14060,MEXTICACAN,0,0,0,0,0,0,0,0,0,0,0,0,0,0,0,0
602,14,JALISCO,14061,MEZQUITIC,0,0,0,0,0,0,0,0,0,0,0,0,0,0,0,0
603,14,JALISCO,14062,MIXTLAN,1,1,0,0,0,0,0,0,0,0,0,0,1,1,0,0
604,14,JALISCO,14063,OCOTLAN,30,9,21,0,0,0,0,0,0,0,0,0,30,9,21,0
605,14,JALISCO,14064,OJUELOS DE JALISCO,40,12,28,0,0,0,0,0,0,0,0,0,40,12,28,0
606,14,JALISCO,14065,PIHUAMO,0,0,0,0,0,0,0,0,0,0,0,0,0,0,0,0
607,14,JALISCO,14066,PONCITLAN,6,4,2,0,0,0,0,0,0,0,0,0,6,4,2,0
608,14,JALISCO,14067,PUERTO VALLARTA,43,5,38,0,0,0,0,0,0,0,0,0,43,5,38,0
609,14,JALISCO,14068,VILLA PURIFICACION,0,0,0,0,0,0,0,0,0,0,0,0,0,0,0,0
610,14,JALISCO,14069,QUITUPAN,0,0,0,0,0,0,0,0,0,0,0,0,0,0,0,0
611,14,JALISCO,14070,EL SALTO,27,24,3,0,0,0,0,0,0,0,0,0,27,24,3,0
612,14,JALISCO,14071,SAN CRISTOBAL DE LA BARRANCA,1,0,1,0,0,0,0,0,0,0,0,0,1,0,1,0
613,14,JALISCO,14072,SAN DIEGO DE ALEJANDRIA,0,0,0,0,0,0,0,0,0,0,0,0,0,0,0,0
614,14,JALISCO,14073,SAN JUAN DE LOS LAGOS,67,30,37,0,0,0,0,0,0,0,0,0,67,30,37,0
615,14,JALISCO,14074,SAN JULIAN,0,0,0,0,0,0,0,0,0,0,0,0,0,0,0,0
616,14,JALISCO,14075,SAN MARCOS,3,1,2,0,0,0,0,0,0,0,0,0,3,1,2,0
617,14,JALISCO,14076,SAN MARTIN DE BOLAÑOS,0,0,0,0,0,0,0,0,0,0,0,0,0,0,0,0
618,14,JALISCO,14077,SAN MARTIN HIDALGO,0,0,0,0,0,0,0,0,0,0,0,0,0,0,0,0
619,14,JALISCO,14078,SAN MIGUEL EL ALTO,2,0,2,0,0,0,0,0,0,0,0,0,2,0,2,0
620,14,JALISCO,14079,GOMEZ FARIAS,0,0,0,0,0,0,0,0,0,0,0,0,0,0,0,0
621,14,JALISCO,14080,SAN SEBASTIAN DEL OESTE,0,0,0,0,0,0,0,0,0,0,0,0,0,0,0,0
622,14,JALISCO,14081,SANTA MARIA DE LOS ANGELES,0,0,0,0,0,0,0,0,0,0,0,0,0,0,0,0
623,14,JALISCO,14082,SAYULA,17,7,10,0,0,0,0,0,0,0,0,0,17,7,10,0
624,14,JALISCO,14083,TALA,19,9,10,0,0,0,0,0,0,0,0,0,19,9,10,0
625,14,JALISCO,14084,TALPA DE ALLENDE,0,0,0,0,0,0,0,0,0,0,0,0,0,0,0,0
626,14,JALISCO,14085,TAMAZULA DE GORDIANO,2,0,2,0,0,0,0,0,0,0,0,0,2,0,2,0
627,14,JALISCO,14086,TAPALPA,0,0,0,0,0,0,0,0,0,0,0,0,0,0,0,0
628,14,JALISCO,14087,TECALITLAN,0,0,0,0,0,0,0,0,0,0,0,0,0,0,0,0
629,14,JALISCO,14088,TECOLOTLAN,6,3,3,0,0,0,0,0,0,0,0,0,6,3,3,0
630,14,JALISCO,14089,TECHALUTA DE MONTENEGRO,0,0,0,0,0,0,0,0,0,0,0,0,0,0,0,0
631,14,JALISCO,14090,TENAMAXTLAN,0,0,0,0,0,0,0,0,0,0,0,0,0,0,0,0
632,14,JALISCO,14091,TEOCALTICHE,0,0,0,0,0,0,0,0,0,0,0,0,0,0,0,0
633,14,JALISCO,14092,TEOCUITATLAN DE CORONA,0,0,0,0,0,0,0,0,0,0,0,0,0,0,0,0
634,14,JALISCO,14093,TEPATITLAN DE MORELOS,151,41,110,0,0,0,0,0,0,0,0,0,151,41,110,0
635,14,JALISCO,14094,TEQUILA,17,7,10,0,0,0,0,0,0,0,0,0,17,7,10,0
636,14,JALISCO,14095,TEUCHITLAN,1,1,0,0,0,0,0,0,0,0,0,0,1,1,0,0
637,14,JALISCO,14096,TIZAPAN EL ALTO,0,0,0,0,0,0,0,0,0,0,0,0,0,0,0,0
638,14,JALISCO,14097,TLAJOMULCO DE ZUÑIGA,75,31,44,0,0,0,0,0,0,0,0,0,75,31,44,0
639,14,JALISCO,14098,SAN PEDRO TLAQUEPAQUE,14,12,2,0,0,0,0,0,0,0,0,0,14,12,2,0
640,14,JALISCO,14099,TOLIMAN,0,0,0,0,0,0,0,0,0,0,0,0,0,0,0,0
641,14,JALISCO,14100,TOMATLAN,5,2,3,0,0,0,0,0,0,0,0,0,5,2,3,0
642,14,JALISCO,14101,TONALA,46,32,14,0,0,0,0,0,0,0,0,0,46,32,14,0
643,14,JALISCO,14102,TONAYA,0,0,0,0,0,0,0,0,0,0,0,0,0,0,0,0
644,14,JALISCO,14103,TONILA,16,13,3,0,0,0,0,0,0,0,0,0,16,13,3,0
645,14,JALISCO,14104,TOTATICHE,0,0,0,0,0,0,0,0,0,0,0,0,0,0,0,0
646,14,JALISCO,14105,TOTOTLAN,0,0,0,0,0,0,0,0,0,0,0,0,0,0,0,0
647,14,JALISCO,14106,TUXCACUESCO,0,0,0,0,0,0,0,0,0,0,0,0,0,0,0,0
648,14,JALISCO,14107,TUXCUECA,0,0,0,0,0,0,0,0,0,0,0,0,0,0,0,0
649,14,JALISCO,14108,TUXPAN,26,10,16,0,0,0,0,0,0,0,0,0,26,10,16,0
650,14,JALISCO,14109,UNION DE SAN ANTONIO,1,0,1,0,0,0,0,0,0,0,0,0,1,0,1,0
651,14,JALISCO,14110,UNION DE TULA,13,1,12,0,0,0,0,0,0,0,0,0,13,1,12,0
652,14,JALISCO,14111,VALLE DE GUADALUPE,1,1,0,0,0,0,0,0,0,0,0,0,1,1,0,0
653,14,JALISCO,14112,VALLE DE JUAREZ,0,0,0,0,0,0,0,0,0,0,0,0,0,0,0,0
654,14,JALISCO,14113,SAN GABRIEL,0,0,0,0,0,0,0,0,0,0,0,0,0,0,0,0
655,14,JALISCO,14114,VILLA CORONA,2,0,2,0,0,0,0,0,0,0,0,0,2,0,2,0
656,14,JALISCO,14115,VILLA GUERRERO,0,0,0,0,0,0,0,0,0,0,0,0,0,0,0,0
657,14,JALISCO,14116,VILLA HIDALGO,0,0,0,0,0,0,0,0,0,0,0,0,0,0,0,0
658,14,JALISCO,14117,CAÑADAS DE OBREGON,0,0,0,0,0,0,0,0,0,0,0,0,0,0,0,0
659,14,JALISCO,14118,YAHUALICA DE GONZALEZ GALLO,0,0,0,0,0,0,0,0,0,0,0,0,0,0,0,0
660,14,JALISCO,14119,ZACOALCO DE TORRES,2,1,1,0,0,0,0,0,0,0,0,0,2,1,1,0
661,14,JALISCO,14120,ZAPOPAN,7,2,5,0,0,0,0,0,0,0,0,0,7,2,5,0
662,14,JALISCO,14121,ZAPOTILTIC,10,2,8,0,0,0,0,0,0,0,0,0,10,2,8,0
663,14,JALISCO,14122,ZAPOTITLAN DE VADILLO,0,0,0,0,0,0,0,0,0,0,0,0,0,0,0,0
664,14,JALISCO,14123,ZAPOTLAN DEL REY,2,2,0,0,0,0,0,0,0,0,0,0,2,2,0,0
665,14,JALISCO,14124,ZAPOTLANEJO,94,29,65,0,0,0,0,0,0,0,0,0,94,29,65,0
666,14,JALISCO,14125,SAN IGNACIO CERRO GORDO,0,0,0,0,0,0,0,0,0,0,0,0,0,0,0,0
667,15,MEXICO,15001,ACAMBAY DE RUIZ CASTAÑEDA,18,2,16,0,0,0,0,0,0,0,0,0,18,2,16,0
668,15,MEXICO,15002,ACOLMAN,35,8,27,0,0,0,0,0,0,0,0,0,35,8,27,0
669,15,MEXICO,15003,ACULCO,4,1,3,0,0,0,0,0,0,0,0,0,4,1,3,0
670,15,MEXICO,15004,ALMOLOYA DE ALQUISIRAS,1,0,1,0,0,0,0,0,0,0,0,0,1,0,1,0
671,15,MEXICO,15005,ALMOLOYA DE JUAREZ,6,3,3,0,0,0,0,0,0,0,0,0,6,3,3,0
672,15,MEXICO,15006,ALMOLOYA DEL RIO,0,0,0,0,0,0,0,0,0,0,0,0,0,0,0,0
673,15,MEXICO,15007,AMANALCO,0,0,0,0,0,0,0,0,0,0,0,0,0,0,0,0
674,15,MEXICO,15008,AMATEPEC,0,0,0,0,0,0,0,0,0,0,0,0,0,0,0,0
675,15,MEXICO,15009,AMECAMECA,22,17,5,0,0,0,0,0,0,0,0,0,22,17,5,0
676,15,MEXICO,15010,APAXCO,2,1,1,0,0,0,0,0,0,0,0,0,2,1,1,0
677,15,MEXICO,15011,ATENCO,6,5,1,0,0,0,0,0,0,0,0,0,6,5,1,0
678,15,MEXICO,15012,ATIZAPAN,1,1,0,0,0,0,0,0,0,0,0,0,1,1,0,0
679,15,MEXICO,15013,ATIZAPAN DE ZARAGOZA,10,3,7,0,0,0,0,0,0,0,0,0,10,3,7,0
680,15,MEXICO,15014,ATLACOMULCO,54,21,33,0,0,0,0,0,0,0,0,0,54,21,33,0
681,15,MEXICO,15015,ATLAUTLA,3,2,1,0,0,0,0,0,0,0,0,0,3,2,1,0
682,15,MEXICO,15016,AXAPUSCO,17,7,10,0,0,0,0,0,0,0,0,0,17,7,10,0
683,15,MEXICO,15017,AYAPANGO,1,1,0,0,0,0,0,0,0,0,0,0,1,1,0,0
684,15,MEXICO,15018,CALIMAYA,3,1,2,0,0,0,0,0,0,0,0,0,3,1,2,0
685,15,MEXICO,15019,CAPULHUAC,0,0,0,0,0,0,0,0,0,0,0,0,0,0,0,0
686,15,MEXICO,15020,COACALCO DE BERRIOZABAL,0,0,0,0,0,0,0,0,0,0,0,0,0,0,0,0
687,15,MEXICO,15021,COATEPEC HARINAS,0,0,0,0,0,0,0,0,0,0,0,0,0,0,0,0
688,15,MEXICO,15022,COCOTITLAN,20,14,6,0,0,0,0,0,0,0,0,0,20,14,6,0
689,15,MEXICO,15023,COYOTEPEC,23,11,12,0,0,0,0,0,0,0,0,0,23,11,12,0
690,15,MEXICO,15024,CUAUTITLAN,11,4,7,0,0,0,0,0,0,0,0,0,11,4,7,0
691,15,MEXICO,15025,CHALCO,109,19,90,0,0,0,0,0,0,0,0,0,109,19,90,0
692,15,MEXICO,15026,CHAPA DE MOTA,0,0,0,0,0,0,0,0,0,0,0,0,0,0,0,0
693,15,MEXICO,15027,CHAPULTEPEC,0,0,0,0,0,0,0,0,0,0,0,0,0,0,0,0
694,15,MEXICO,15028,CHIAUTLA,0,0,0,0,0,0,0,0,0,0,0,0,0,0,0,0
695,15,MEXICO,15029,CHICOLOAPAN,2,1,1,0,0,0,0,0,0,0,0,0,2,1,1,0
696,15,MEXICO,15030,CHICONCUAC,0,0,0,0,0,0,0,0,0,0,0,0,0,0,0,0
697,15,MEXICO,15031,CHIMALHUACAN,0,0,0,0,0,0,0,0,0,0,0,0,0,0,0,0
698,15,MEXICO,15032,DONATO GUERRA,0,0,0,0,0,0,0,0,0,0,0,0,0,0,0,0
699,15,MEXICO,15033,ECATEPEC DE MORELOS,119,40,79,0,0,0,0,0,0,0,0,0,119,40,79,0
700,15,MEXICO,15034,ECATZINGO,0,0,0,0,0,0,0,0,0,0,0,0,0,0,0,0
701,15,MEXICO,15035,HUEHUETOCA,66,29,37,0,0,0,0,0,0,0,0,0,66,29,37,0
702,15,MEXICO,15036,HUEYPOXTLA,0,0,0,0,0,0,0,0,0,0,0,0,0,0,0,0
703,15,MEXICO,15037,HUIXQUILUCAN,4,2,2,0,0,0,0,0,0,0,0,0,4,2,2,0
704,15,MEXICO,15038,ISIDRO FABELA,0,0,0,0,0,0,0,0,0,0,0,0,0,0,0,0
705,15,MEXICO,15039,IXTAPALUCA,65,23,42,0,0,0,0,0,0,0,0,0,65,23,42,0
706,15,MEXICO,15040,IXTAPAN DE LA SAL,4,4,0,0,0,0,0,0,0,0,0,0,4,4,0,0
707,15,MEXICO,15041,IXTAPAN DEL ORO,0,0,0,0,0,0,0,0,0,0,0,0,0,0,0,0
708,15,MEXICO,15042,IXTLAHUACA,4,2,2,0,0,0,0,0,0,0,0,0,4,2,2,0
709,15,MEXICO,15043,XALATLACO,0,0,0,0,0,0,0,0,0,0,0,0,0,0,0,0
710,15,MEXICO,15044,JALTENCO,0,0,0,0,0,0,0,0,0,0,0,0,0,0,0,0
711,15,MEXICO,15045,JILOTEPEC,69,22,47,0,0,0,0,0,0,0,0,0,69,22,47,0
712,15,MEXICO,15046,JILOTZINGO,0,0,0,0,0,0,0,0,0,0,0,0,0,0,0,0
713,15,MEXICO,15047,JIQUIPILCO,0,0,0,0,0,0,0,0,0,0,0,0,0,0,0,0
714,15,MEXICO,15048,JOCOTITLAN,7,1,6,0,0,0,0,0,0,0,0,0,7,1,6,0
715,15,MEXICO,15049,JOQUICINGO,0,0,0,0,0,0,0,0,0,0,0,0,0,0,0,0
716,15,MEXICO,15050,JUCHITEPEC,0,0,0,0,0,0,0,0,0,0,0,0,0,0,0,0
717,15,MEXICO,15051,LERMA,11,8,3,0,0,0,0,0,0,0,0,0,11,8,3,0
718,15,MEXICO,15052,MALINALCO,0,0,0,0,0,0,0,0,0,0,0,0,0,0,0,0
719,15,MEXICO,15053,MELCHOR OCAMPO,2,0,2,0,0,0,0,0,0,0,0,0,2,0,2,0
720,15,MEXICO,15054,METEPEC,1,1,0,0,0,0,0,0,0,0,0,0,1,1,0,0
721,15,MEXICO,15055,MEXICALTZINGO,1,1,0,0,0,0,0,0,0,0,0,0,1,1,0,0
722,15,MEXICO,15056,MORELOS,1,0,1,0,0,0,0,0,0,0,0,0,1,0,1,0
723,15,MEXICO,15057,NAUCALPAN DE JUAREZ,25,8,17,0,0,0,0,0,0,0,0,0,25,8,17,0
724,15,MEXICO,15058,NEZAHUALCOYOTL,0,0,0,0,0,0,0,0,0,0,0,0,0,0,0,0
725,15,MEXICO,15059,NEXTLALPAN,3,1,2,0,0,0,0,0,0,0,0,0,3,1,2,0
726,15,MEXICO,15060,NICOLAS ROMERO,0,0,0,0,0,0,0,0,0,0,0,0,0,0,0,0
727,15,MEXICO,15061,NOPALTEPEC,52,9,43,0,0,0,0,0,0,0,0,0,52,9,43,0
728,15,MEXICO,15062,OCOYOACAC,16,8,8,0,0,0,0,0,0,0,0,0,16,8,8,0
729,15,MEXICO,15063,OCUILAN,0,0,0,0,0,0,0,0,0,0,0,0,0,0,0,0
730,15,MEXICO,15064,EL ORO,0,0,0,0,0,0,0,0,0,0,0,0,0,0,0,0
731,15,MEXICO,15065,OTUMBA,15,6,9,0,0,0,0,0,0,0,0,0,15,6,9,0
732,15,MEXICO,15066,OTZOLOAPAN,0,0,0,0,0,0,0,0,0,0,0,0,0,0,0,0
733,15,MEXICO,15067,OTZOLOTEPEC,0,0,0,0,0,0,0,0,0,0,0,0,0,0,0,0
734,15,MEXICO,15068,OZUMBA,1,0,1,0,0,0,0,0,0,0,0,0,1,0,1,0
735,15,MEXICO,15069,PAPALOTLA,0,0,0,0,0,0,0,0,0,0,0,0,0,0,0,0
736,15,MEXICO,15070,LA PAZ,1,1,0,0,0,0,0,0,0,0,0,0,1,1,0,0
737,15,MEXICO,15071,POLOTITLAN,27,13,14,0,0,0,0,0,0,0,0,0,27,13,14,0
738,15,MEXICO,15072,RAYON,1,0,1,0,0,0,0,0,0,0,0,0,1,0,1,0
739,15,MEXICO,15073,SAN ANTONIO LA ISLA,2,1,1,0,0,0,0,0,0,0,0,0,2,1,1,0
740,15,MEXICO,15074,SAN FELIPE DEL PROGRESO,0,0,0,0,0,0,0,0,0,0,0,0,0,0,0,0
741,15,MEXICO,15075,SAN MARTIN DE LAS PIRAMIDES,6,1,5,0,0,0,0,0,0,0,0,0,6,1,5,0
742,15,MEXICO,15076,SAN MATEO ATENCO,0,0,0,0,0,0,0,0,0,0,0,0,0,0,0,0
743,15,MEXICO,15077,SAN SIMON DE GUERRERO,0,0,0,0,0,0,0,0,0,0,0,0,0,0,0,0
744,15,MEXICO,15078,SANTO TOMAS,0,0,0,0,0,0,0,0,0,0,0,0,0,0,0,0
745,15,MEXICO,15079,SOYANIQUILPAN DE JUAREZ,7,6,1,0,0,0,0,0,0,0,0,0,7,6,1,0
746,15,MEXICO,15080,SULTEPEC,0,0,0,0,0,0,0,0,0,0,0,0,0,0,0,0
747,15,MEXICO,15081,TECAMAC,95,20,75,0,0,0,0,0,0,0,0,0,95,20,75,0
748,15,MEXICO,15082,TEJUPILCO,1,1,0,0,0,0,0,0,0,0,0,0,1,1,0,0
749,15,MEXICO,15083,TEMAMATLA,0,0,0,0,0,0,0,0,0,0,0,0,0,0,0,0
750,15,MEXICO,15084,TEMASCALAPA,0,0,0,0,0,0,0,0,0,0,0,0,0,0,0,0
751,15,MEXICO,15085,TEMASCALCINGO,0,0,0,0,0,0,0,0,0,0,0,0,0,0,0,0
752,15,MEXICO,15086,TEMASCALTEPEC,1,1,0,0,0,0,0,0,0,0,0,0,1,1,0,0
753,15,MEXICO,15087,TEMOAYA,0,0,0,0,0,0,0,0,0,0,0,0,0,0,0,0
754,15,MEXICO,15088,TENANCINGO,1,1,0,0,0,0,0,0,0,0,0,0,1,1,0,0
755,15,MEXICO,15089,TENANGO DEL AIRE,0,0,0,0,0,0,0,0,0,0,0,0,0,0,0,0
756,15,MEXICO,15090,TENANGO DEL VALLE,2,2,0,0,0,0,0,0,0,0,0,0,2,2,0,0
757,15,MEXICO,15091,TEOLOYUCAN,8,3,5,0,0,0,0,0,0,0,0,0,8,3,5,0
758,15,MEXICO,15092,TEOTIHUACAN,8,2,6,0,0,0,0,0,0,0,0,0,8,2,6,0
759,15,MEXICO,15093,TEPETLAOXTOC,11,1,10,0,0,0,0,0,0,0,0,0,11,1,10,0
760,15,MEXICO,15094,TEPETLIXPA,4,2,2,0,0,0,0,0,0,0,0,0,4,2,2,0
761,15,MEXICO,15095,TEPOTZOTLAN,61,11,50,0,0,0,0,0,0,0,0,0,61,11,50,0
762,15,MEXICO,15096,TEQUIXQUIAC,0,0,0,0,0,0,0,0,0,0,0,0,0,0,0,0
763,15,MEXICO,15097,TEXCALTITLAN,0,0,0,0,0,0,0,0,0,0,0,0,0,0,0,0
764,15,MEXICO,15098,TEXCALYACAC,0,0,0,0,0,0,0,0,0,0,0,0,0,0,0,0
765,15,MEXICO,15099,TEXCOCO,76,26,50,0,0,0,0,0,0,0,0,0,76,26,50,0
766,15,MEXICO,15100,TEZOYUCA,22,8,14,0,0,0,0,0,0,0,0,0,22,8,14,0
767,15,MEXICO,15101,TIANGUISTENCO,0,0,0,0,0,0,0,0,0,0,0,0,0,0,0,0
768,15,MEXICO,15102,TIMILPAN,0,0,0,0,0,0,0,0,0,0,0,0,0,0,0,0
769,15,MEXICO,15103,TLALMANALCO,12,11,1,0,0,0,0,0,0,0,0,0,12,11,1,0
770,15,MEXICO,15104,TLALNEPANTLA DE BAZ,10,2,8,0,0,0,0,0,0,0,0,0,10,2,8,0
771,15,MEXICO,15105,TLATLAYA,0,0,0,0,0,0,0,0,0,0,0,0,0,0,0,0
772,15,MEXICO,15106,TOLUCA,28,18,10,0,0,0,0,0,0,0,0,0,28,18,10,0
773,15,MEXICO,15107,TONATICO,2,1,1,0,0,0,0,0,0,0,0,0,2,1,1,0
774,15,MEXICO,15108,TULTEPEC,1,1,0,0,0,0,0,0,0,0,0,0,1,1,0,0
775,15,MEXICO,15109,TULTITLAN,6,3,3,0,0,0,0,0,0,0,0,0,6,3,3,0
776,15,MEXICO,15110,VALLE DE BRAVO,0,0,0,0,0,0,0,0,0,0,0,0,0,0,0,0
777,15,MEXICO,15111,VILLA DE ALLENDE,0,0,0,0,0,0,0,0,0,0,0,0,0,0,0,0
778,15,MEXICO,15112,VILLA DEL CARBON,0,0,0,0,0,0,0,0,0,0,0,0,0,0,0,0
779,15,MEXICO,15113,VILLA GUERRERO,1,1,0,0,0,0,0,0,0,0,0,0,1,1,0,0
780,15,MEXICO,15114,VILLA VICTORIA,2,0,2,0,0,0,0,0,0,0,0,0,2,0,2,0
781,15,MEXICO,15115,XONACATLAN,8,8,0,0,0,0,0,0,0,0,0,0,8,8,0,0
782,15,MEXICO,15116,ZACAZONAPAN,0,0,0,0,0,0,0,0,0,0,0,0,0,0,0,0
783,15,MEXICO,15117,ZACUALPAN,0,0,0,0,0,0,0,0,0,0,0,0,0,0,0,0
784,15,MEXICO,15118,ZINACANTEPEC,43,22,21,0,0,0,0,0,0,0,0,0,43,22,21,0
785,15,MEXICO,15119,ZUMPAHUACAN,0,0,0,0,0,0,0,0,0,0,0,0,0,0,0,0
786,15,MEXICO,15120,ZUMPANGO,2,0,2,0,0,0,0,0,0,0,0,0,2,0,2,0
787,15,MEXICO,15121,CUAUTITLAN IZCALLI,50,21,29,0,0,0,0,0,0,0,0,0,50,21,29,0
788,15,MEXICO,15122,VALLE DE CHALCO SOLIDARIDAD,12,6,6,0,0,0,0,0,0,0,0,0,12,6,6,0
789,15,MEXICO,15123,LUVIANOS,0,0,0,0,0,0,0,0,0,0,0,0,0,0,0,0
790,15,MEXICO,15124,SAN JOSE DEL RINCON,0,0,0,0,0,0,0,0,0,0,0,0,0,0,0,0
791,15,MEXICO,15125,TONANITLA,0,0,0,0,0,0,0,0,0,0,0,0,0,0,0,0
792,16,MICHOACAN DE OCAMPO,16001,ACUITZIO,0,0,0,0,0,0,0,0,0,0,0,0,0,0,0,0
793,16,MICHOACAN DE OCAMPO,16002,AGUILILLA,1,1,0,0,0,0,0,0,0,0,0,0,1,1,0,0
794,16,MICHOACAN DE OCAMPO,16003,ALVARO OBREGON,1,1,0,0,0,0,0,0,0,0,0,0,1,1,0,0
795,16,MICHOACAN DE OCAMPO,16004,ANGAMACUTIRO,0,0,0,0,0,0,0,0,0,0,0,0,0,0,0,0
796,16,MICHOACAN DE OCAMPO,16005,ANGANGUEO,0,0,0,0,0,0,0,0,0,0,0,0,0,0,0,0
797,16,MICHOACAN DE OCAMPO,16006,APATZINGAN,8,6,2,0,0,0,0,0,0,0,0,0,8,6,2,0
798,16,MICHOACAN DE OCAMPO,16007,APORO,0,0,0,0,0,0,0,0,0,0,0,0,0,0,0,0
799,16,MICHOACAN DE OCAMPO,16008,AQUILA,3,2,1,0,0,0,0,0,0,0,0,0,3,2,1,0
800,16,MICHOACAN DE OCAMPO,16009,ARIO,1,1,0,0,0,0,0,0,0,0,0,0,1,1,0,0
801,16,MICHOACAN DE OCAMPO,16010,ARTEAGA,4,4,0,0,0,0,0,0,0,0,0,0,4,4,0,0
802,16,MICHOACAN DE OCAMPO,16011,BRISEÑAS,1,1,0,0,0,0,0,0,0,0,0,0,1,1,0,0
803,16,MICHOACAN DE OCAMPO,16012,BUENAVISTA,5,5,0,0,0,0,0,0,0,0,0,0,5,5,0,0
804,16,MICHOACAN DE OCAMPO,16013,CARACUARO,2,0,2,0,0,0,0,0,0,0,0,0,2,0,2,0
805,16,MICHOACAN DE OCAMPO,16014,COAHUAYANA,0,0,0,0,0,0,0,0,0,0,0,0,0,0,0,0
806,16,MICHOACAN DE OCAMPO,16015,COALCOMAN DE VAZQUEZ PALLARES,0,0,0,0,0,0,0,0,0,0,0,0,0,0,0,0
807,16,MICHOACAN DE OCAMPO,16016,COENEO,1,1,0,0,0,0,0,0,0,0,0,0,1,1,0,0
808,16,MICHOACAN DE OCAMPO,16017,CONTEPEC,11,3,8,0,0,0,0,0,0,0,0,0,11,3,8,0
809,16,MICHOACAN DE OCAMPO,16018,COPANDARO,12,1,11,0,0,0,0,0,0,0,0,0,12,1,11,0
810,16,MICHOACAN DE OCAMPO,16019,COTIJA,14,14,0,0,0,0,0,0,0,0,0,0,14,14,0,0
811,16,MICHOACAN DE OCAMPO,16020,CUITZEO,29,10,19,0,0,0,0,0,0,0,0,0,29,10,19,0
812,16,MICHOACAN DE OCAMPO,16021,CHARAPAN,1,1,0,0,0,0,0,0,0,0,0,0,1,1,0,0
813,16,MICHOACAN DE OCAMPO,16022,CHARO,1,1,0,0,0,0,0,0,0,0,0,0,1,1,0,0
814,16,MICHOACAN DE OCAMPO,16023,CHAVINDA,0,0,0,0,0,0,0,0,0,0,0,0,0,0,0,0
815,16,MICHOACAN DE OCAMPO,16024,CHERAN,0,0,0,0,0,0,0,0,0,0,0,0,0,0,0,0
816,16,MICHOACAN DE OCAMPO,16025,CHILCHOTA,4,2,2,0,0,0,0,0,0,0,0,0,4,2,2,0
817,16,MICHOACAN DE OCAMPO,16026,CHINICUILA,0,0,0,0,0,0,0,0,0,0,0,0,0,0,0,0
818,16,MICHOACAN DE OCAMPO,16027,CHUCANDIRO,0,0,0,0,0,0,0,0,0,0,0,0,0,0,0,0
819,16,MICHOACAN DE OCAMPO,16028,CHURINTZIO,10,5,5,0,0,0,0,0,0,0,0,0,10,5,5,0
820,16,MICHOACAN DE OCAMPO,16029,CHURUMUCO,0,0,0,0,0,0,0,0,0,0,0,0,0,0,0,0
821,16,MICHOACAN DE OCAMPO,16030,ECUANDUREO,23,6,17,0,0,0,0,0,0,0,0,0,23,6,17,0
822,16,MICHOACAN DE OCAMPO,16031,EPITACIO HUERTA,0,0,0,0,0,0,0,0,0,0,0,0,0,0,0,0
823,16,MICHOACAN DE OCAMPO,16032,ERONGARICUARO,0,0,0,0,0,0,0,0,0,0,0,0,0,0,0,0
824,16,MICHOACAN DE OCAMPO,16033,GABRIEL ZAMORA,7,7,0,0,0,0,0,0,0,0,0,0,7,7,0,0
825,16,MICHOACAN DE OCAMPO,16034,HIDALGO,14,4,10,0,0,0,0,0,0,0,0,0,14,4,10,0
826,16,MICHOACAN DE OCAMPO,16035,LA HUACANA,2,2,0,0,0,0,0,0,0,0,0,0,2,2,0,0
827,16,MICHOACAN DE OCAMPO,16036,HUANDACAREO,0,0,0,0,0,0,0,0,0,0,0,0,0,0,0,0
828,16,MICHOACAN DE OCAMPO,16037,HUANIQUEO,4,4,0,0,0,0,0,0,0,0,0,0,4,4,0,0
829,16,MICHOACAN DE OCAMPO,16038,HUETAMO,0,0,0,0,0,0,0,0,0,0,0,0,0,0,0,0
830,16,MICHOACAN DE OCAMPO,16039,HUIRAMBA,1,1,0,0,0,0,0,0,0,0,0,0,1,1,0,0
831,16,MICHOACAN DE OCAMPO,16040,INDAPARAPEO,0,0,0,0,0,0,0,0,0,0,0,0,0,0,0,0
832,16,MICHOACAN DE OCAMPO,16041,IRIMBO,1,1,0,0,0,0,0,0,0,0,0,0,1,1,0,0
833,16,MICHOACAN DE OCAMPO,16042,IXTLAN,1,1,0,0,0,0,0,0,0,0,0,0,1,1,0,0
834,16,MICHOACAN DE OCAMPO,16043,JACONA,4,2,2,0,0,0,0,0,0,0,0,0,4,2,2,0
835,16,MICHOACAN DE OCAMPO,16044,JIMENEZ,0,0,0,0,0,0,0,0,0,0,0,0,0,0,0,0
836,16,MICHOACAN DE OCAMPO,16045,JIQUILPAN,12,7,5,0,0,0,0,0,0,0,0,0,12,7,5,0
837,16,MICHOACAN DE OCAMPO,16046,JUAREZ,2,1,1,0,0,0,0,0,0,0,0,0,2,1,1,0
838,16,MICHOACAN DE OCAMPO,16047,JUNGAPEO,0,0,0,0,0,0,0,0,0,0,0,0,0,0,0,0
839,16,MICHOACAN DE OCAMPO,16048,LAGUNILLAS,3,1,2,0,0,0,0,0,0,0,0,0,3,1,2,0
840,16,MICHOACAN DE OCAMPO,16049,MADERO,3,3,0,0,0,0,0,0,0,0,0,0,3,3,0,0
841,16,MICHOACAN DE OCAMPO,16050,MARAVATIO,15,10,5,0,0,0,0,0,0,0,0,0,15,10,5,0
842,16,MICHOACAN DE OCAMPO,16051,MARCOS CASTELLANOS,9,6,3,0,0,0,0,0,0,0,0,0,9,6,3,0
843,16,MICHOACAN DE OCAMPO,16052,LAZARO CARDENAS,14,9,5,0,0,0,0,0,0,0,0,0,14,9,5,0
844,16,MICHOACAN DE OCAMPO,16053,MORELIA,28,18,10,0,0,0,0,0,0,0,0,0,28,18,10,0
845,16,MICHOACAN DE OCAMPO,16054,MORELOS,0,0,0,0,0,0,0,0,0,0,0,0,0,0,0,0
846,16,MICHOACAN DE OCAMPO,16055,MUGICA,11,9,2,0,0,0,0,0,0,0,0,0,11,9,2,0
847,16,MICHOACAN DE OCAMPO,16056,NAHUATZEN,0,0,0,0,0,0,0,0,0,0,0,0,0,0,0,0
848,16,MICHOACAN DE OCAMPO,16057,NOCUPETARO,2,2,0,0,0,0,0,0,0,0,0,0,2,2,0,0
849,16,MICHOACAN DE OCAMPO,16058,NUEVO PARANGARICUTIRO,0,0,0,0,0,0,0,0,0,0,0,0,0,0,0,0
850,16,MICHOACAN DE OCAMPO,16059,NUEVO URECHO,0,0,0,0,0,0,0,0,0,0,0,0,0,0,0,0
851,16,MICHOACAN DE OCAMPO,16060,NUMARAN,0,0,0,0,0,0,0,0,0,0,0,0,0,0,0,0
852,16,MICHOACAN DE OCAMPO,16061,OCAMPO,0,0,0,0,0,0,0,0,0,0,0,0,0,0,0,0
853,16,MICHOACAN DE OCAMPO,16062,PAJACUARAN,3,2,1,0,0,0,0,0,0,0,0,0,3,2,1,0
854,16,MICHOACAN DE OCAMPO,16063,PANINDICUARO,5,3,2,0,0,0,0,0,0,0,0,0,5,3,2,0
855,16,MICHOACAN DE OCAMPO,16064,PARACUARO,3,1,2,0,0,0,0,0,0,0,0,0,3,1,2,0
856,16,MICHOACAN DE OCAMPO,16065,PARACHO,2,1,1,0,0,0,0,0,0,0,0,0,2,1,1,0
857,16,MICHOACAN DE OCAMPO,16066,PATZCUARO,25,15,10,0,0,0,0,0,0,0,0,0,25,15,10,0
858,16,MICHOACAN DE OCAMPO,16067,PENJAMILLO,1,1,0,0,0,0,0,0,0,0,0,0,1,1,0,0
859,16,MICHOACAN DE OCAMPO,16068,PERIBAN,1,0,1,0,0,0,0,0,0,0,0,0,1,0,1,0
860,16,MICHOACAN DE OCAMPO,16069,LA PIEDAD,14,9,5,0,0,0,0,0,0,0,0,0,14,9,5,0
861,16,MICHOACAN DE OCAMPO,16070,PUREPERO,0,0,0,0,0,0,0,0,0,0,0,0,0,0,0,0
862,16,MICHOACAN DE OCAMPO,16071,PURUANDIRO,0,0,0,0,0,0,0,0,0,0,0,0,0,0,0,0
863,16,MICHOACAN DE OCAMPO,16072,QUERENDARO,0,0,0,0,0,0,0,0,0,0,0,0,0,0,0,0
864,16,MICHOACAN DE OCAMPO,16073,QUIROGA,0,0,0,0,0,0,0,0,0,0,0,0,0,0,0,0
865,16,MICHOACAN DE OCAMPO,16074,COJUMATLAN DE REGULES,0,0,0,0,0,0,0,0,0,0,0,0,0,0,0,0
866,16,MICHOACAN DE OCAMPO,16075,LOS REYES,0,0,0,0,0,0,0,0,0,0,0,0,0,0,0,0
867,16,MICHOACAN DE OCAMPO,16076,SAHUAYO,6,6,0,0,0,0,0,0,0,0,0,0,6,6,0,0
868,16,MICHOACAN DE OCAMPO,16077,SAN LUCAS,0,0,0,0,0,0,0,0,0,0,0,0,0,0,0,0
869,16,MICHOACAN DE OCAMPO,16078,SANTA ANA MAYA,0,0,0,0,0,0,0,0,0,0,0,0,0,0,0,0
870,16,MICHOACAN DE OCAMPO,16079,SALVADOR ESCALANTE,2,2,0,0,0,0,0,0,0,0,0,0,2,2,0,0
871,16,MICHOACAN DE OCAMPO,16080,SENGUIO,0,0,0,0,0,0,0,0,0,0,0,0,0,0,0,0
872,16,MICHOACAN DE OCAMPO,16081,SUSUPUATO,0,0,0,0,0,0,0,0,0,0,0,0,0,0,0,0
873,16,MICHOACAN DE OCAMPO,16082,TACAMBARO,2,0,2,0,0,0,0,0,0,0,0,0,2,0,2,0
874,16,MICHOACAN DE OCAMPO,16083,TANCITARO,0,0,0,0,0,0,0,0,0,0,0,0,0,0,0,0
875,16,MICHOACAN DE OCAMPO,16084,TANGAMANDAPIO,4,3,1,0,0,0,0,0,0,0,0,0,4,3,1,0
876,16,MICHOACAN DE OCAMPO,16085,TANGANCICUARO,7,7,0,0,0,0,0,0,0,0,0,0,7,7,0,0
877,16,MICHOACAN DE OCAMPO,16086,TANHUATO,14,8,6,0,0,0,0,0,0,0,0,0,14,8,6,0
878,16,MICHOACAN DE OCAMPO,16087,TARETAN,13,5,8,0,0,0,0,0,0,0,0,0,13,5,8,0
879,16,MICHOACAN DE OCAMPO,16088,TARIMBARO,8,4,4,0,0,0,0,0,0,0,0,0,8,4,4,0
880,16,MICHOACAN DE OCAMPO,16089,TEPALCATEPEC,1,1,0,0,0,0,0,0,0,0,0,0,1,1,0,0
881,16,MICHOACAN DE OCAMPO,16090,TINGAMBATO,0,0,0,0,0,0,0,0,0,0,0,0,0,0,0,0
882,16,MICHOACAN DE OCAMPO,16091,TINGUINDIN,0,0,0,0,0,0,0,0,0,0,0,0,0,0,0,0
883,16,MICHOACAN DE OCAMPO,16092,TIQUICHEO DE NICOLAS ROMERO,3,3,0,0,0,0,0,0,0,0,0,0,3,3,0,0
884,16,MICHOACAN DE OCAMPO,16093,TLALPUJAHUA,0,0,0,0,0,0,0,0,0,0,0,0,0,0,0,0
885,16,MICHOACAN DE OCAMPO,16094,TLAZAZALCA,9,1,8,0,0,0,0,0,0,0,0,0,9,1,8,0
886,16,MICHOACAN DE OCAMPO,16095,TOCUMBO,2,1,1,0,0,0,0,0,0,0,0,0,2,1,1,0
887,16,MICHOACAN DE OCAMPO,16096,TUMBISCATIO,0,0,0,0,0,0,0,0,0,0,0,0,0,0,0,0
888,16,MICHOACAN DE OCAMPO,16097,TURICATO,0,0,0,0,0,0,0,0,0,0,0,0,0,0,0,0
889,16,MICHOACAN DE OCAMPO,16098,TUXPAN,0,0,0,0,0,0,0,0,0,0,0,0,0,0,0,0
890,16,MICHOACAN DE OCAMPO,16099,TUZANTLA,0,0,0,0,0,0,0,0,0,0,0,0,0,0,0,0
891,16,MICHOACAN DE OCAMPO,16100,TZINTZUNTZAN,0,0,0,0,0,0,0,0,0,0,0,0,0,0,0,0
892,16,MICHOACAN DE OCAMPO,16101,TZITZIO,0,0,0,0,0,0,0,0,0,0,0,0,0,0,0,0
893,16,MICHOACAN DE OCAMPO,16102,URUAPAN,75,57,18,0,0,0,0,0,0,0,0,0,75,57,18,0
894,16,MICHOACAN DE OCAMPO,16103,VENUSTIANO CARRANZA,1,1,0,0,0,0,0,0,0,0,0,0,1,1,0,0
895,16,MICHOACAN DE OCAMPO,16104,VILLAMAR,0,0,0,0,0,0,0,0,0,0,0,0,0,0,0,0
896,16,MICHOACAN DE OCAMPO,16105,VISTA HERMOSA,2,0,2,0,0,0,0,0,0,0,0,0,2,0,2,0
897,16,MICHOACAN DE OCAMPO,16106,YURECUARO,22,5,17,0,0,0,0,0,0,0,0,0,22,5,17,0
898,16,MICHOACAN DE OCAMPO,16107,ZACAPU,5,5,0,0,0,0,0,0,0,0,0,0,5,5,0,0
899,16,MICHOACAN DE OCAMPO,16108,ZAMORA,53,36,17,0,0,0,0,0,0,0,0,0,53,36,17,0
900,16,MICHOACAN DE OCAMPO,16109,ZINAPARO,0,0,0,0,0,0,0,0,0,0,0,0,0,0,0,0
901,16,MICHOACAN DE OCAMPO,16110,ZINAPECUARO,10,1,9,0,0,0,0,0,0,0,0,0,10,1,9,0
902,16,MICHOACAN DE OCAMPO,16111,ZIRACUARETIRO,4,4,0,0,0,0,0,0,0,0,0,0,4,4,0,0
903,16,MICHOACAN DE OCAMPO,16112,ZITACUARO,2,1,1,0,0,0,0,0,0,0,0,0,2,1,1,0
904,16,MICHOACAN DE OCAMPO,16113,JOSE SIXTO VERDUZCO,1,0,1,0,0,0,0,0,0,0,0,0,1,0,1,0
905,17,MORELOS,17001,AMACUZAC,1,0,1,0,0,0,0,0,0,0,0,0,1,0,1,0
906,17,MORELOS,17002,ATLATLAHUCAN,37,6,31,0,0,0,0,0,0,0,0,0,37,6,31,0
907,17,MORELOS,17003,AXOCHIAPAN,1,0,1,0,0,0,0,0,0,0,0,0,1,0,1,0
908,17,MORELOS,17004,AYALA,10,2,8,0,0,0,0,0,0,0,0,0,10,2,8,0
909,17,MORELOS,17005,COATLAN DEL RIO,0,0,0,0,0,0,0,0,0,0,0,0,0,0,0,0
910,17,MORELOS,17006,CUAUTLA,45,8,37,0,0,0,0,0,0,0,0,0,45,8,37,0
911,17,MORELOS,17007,CUERNAVACA,13,9,4,0,0,0,0,0,0,0,0,0,13,9,4,0
912,17,MORELOS,17008,EMILIANO ZAPATA,0,0,0,0,0,0,0,0,0,0,0,0,0,0,0,0
913,17,MORELOS,17009,HUITZILAC,4,2,2,0,0,0,0,0,0,0,0,0,4,2,2,0
914,17,MORELOS,17010,JANTETELCO,17,5,12,0,0,0,0,0,0,0,0,0,17,5,12,0
915,17,MORELOS,17011,JIUTEPEC,0,0,0,0,0,0,0,0,0,0,0,0,0,0,0,0
916,17,MORELOS,17012,JOJUTLA,2,0,2,0,0,0,0,0,0,0,0,0,2,0,2,0
917,17,MORELOS,17013,JONACATEPEC DE LEANDRO VALLE,1,1,0,0,0,0,0,0,0,0,0,0,1,1,0,0
918,17,MORELOS,17014,MAZATEPEC,0,0,0,0,0,0,0,0,0,0,0,0,0,0,0,0
919,17,MORELOS,17015,MIACATLAN,0,0,0,0,0,0,0,0,0,0,0,0,0,0,0,0
920,17,MORELOS,17016,OCUITUCO,0,0,0,0,0,0,0,0,0,0,0,0,0,0,0,0
921,17,MORELOS,17017,PUENTE DE IXTLA,13,3,10,0,0,0,0,0,0,0,0,0,13,3,10,0
922,17,MORELOS,17018,TEMIXCO,3,2,1,0,0,0,0,0,0,0,0,0,3,2,1,0
923,17,MORELOS,17019,TEPALCINGO,0,0,0,0,0,0,0,0,0,0,0,0,0,0,0,0
924,17,MORELOS,17020,TEPOZTLAN,1,1,0,0,0,0,0,0,0,0,0,0,1,1,0,0
925,17,MORELOS,17021,TETECALA,0,0,0,0,0,0,0,0,0,0,0,0,0,0,0,0
926,17,MORELOS,17022,TETELA DEL VOLCAN,0,0,0,0,0,0,0,0,0,0,0,0,0,0,0,0
927,17,MORELOS,17023,TLALNEPANTLA,0,0,0,0,0,0,0,0,0,0,0,0,0,0,0,0
928,17,MORELOS,17024,TLALTIZAPAN DE ZAPATA,1,0,1,0,0,0,0,0,0,0,0,0,1,0,1,0
929,17,MORELOS,17025,TLAQUILTENANGO,0,0,0,0,0,0,0,0,0,0,0,0,0,0,0,0
930,17,MORELOS,17026,TLAYACAPAN,0,0,0,0,0,0,0,0,0,0,0,0,0,0,0,0
931,17,MORELOS,17027,TOTOLAPAN,0,0,0,0,0,0,0,0,0,0,0,0,0,0,0,0
932,17,MORELOS,17028,XOCHITEPEC,8,4,4,0,0,0,0,0,0,0,0,0,8,4,4,0
933,17,MORELOS,17029,YAUTEPEC,34,11,23,0,0,0,0,0,0,0,0,0,34,11,23,0
934,17,MORELOS,17030,YECAPIXTLA,2,0,2,0,0,0,0,0,0,0,0,0,2,0,2,0
935,17,MORELOS,17031,ZACATEPEC,0,0,0,0,0,0,0,0,0,0,0,0,0,0,0,0
936,17,MORELOS,17032,ZACUALPAN DE AMILPAS,0,0,0,0,0,0,0,0,0,0,0,0,0,0,0,0
937,17,MORELOS,17033,TEMOAC,0,0,0,0,0,0,0,0,0,0,0,0,0,0,0,0
938,17,MORELOS,17034,COATETELCO,0,0,0,0,0,0,0,0,0,0,0,0,0,0,0,0
939,17,MORELOS,17035,XOXOCOTLA,0,0,0,0,0,0,0,0,0,0,0,0,0,0,0,0
940,17,MORELOS,17036,HUEYAPAN,0,0,0,0,0,0,0,0,0,0,0,0,0,0,0,0
941,18,NAYARIT,18001,ACAPONETA,8,2,6,0,0,0,0,0,0,0,0,0,8,2,6,0
942,18,NAYARIT,18002,AHUACATLAN,20,12,8,0,0,0,0,0,0,0,0,0,20,12,8,0
943,18,NAYARIT,18003,AMATLAN DE CAÑAS,0,0,0,0,0,0,0,0,0,0,0,0,0,0,0,0
944,18,NAYARIT,18004,COMPOSTELA,44,4,40,0,0,0,0,0,0,0,0,0,44,4,40,0
945,18,NAYARIT,18005,HUAJICORI,0,0,0,0,0,0,0,0,0,0,0,0,0,0,0,0
946,18,NAYARIT,18006,IXTLAN DEL RIO,27,17,10,0,0,0,0,0,0,0,0,0,27,17,10,0
947,18,NAYARIT,18007,JALA,12,5,7,0,0,0,0,0,0,0,0,0,12,5,7,0
948,18,NAYARIT,18008,XALISCO,11,2,9,0,0,0,0,0,0,0,0,0,11,2,9,0
949,18,NAYARIT,18009,DEL NAYAR,0,0,0,0,0,0,0,0,0,0,0,0,0,0,0,0
950,18,NAYARIT,18010,ROSAMORADA,43,2,41,0,0,0,0,0,0,0,0,0,43,2,41,0
951,18,NAYARIT,18011,RUIZ,17,2,15,0,0,0,0,0,0,0,0,0,17,2,15,0
952,18,NAYARIT,18012,SAN BLAS,3,0,3,0,0,0,0,0,0,0,0,0,3,0,3,0
953,18,NAYARIT,18013,SAN PEDRO LAGUNILLAS,1,0,1,0,0,0,0,0,0,0,0,0,1,0,1,0
954,18,NAYARIT,18014,SANTA MARIA DEL ORO,77,4,73,0,0,0,0,0,0,0,0,0,77,4,73,0
955,18,NAYARIT,18015,SANTIAGO IXCUINTLA,1,1,0,0,0,0,0,0,0,0,0,0,1,1,0,0
956,18,NAYARIT,18016,TECUALA,1,0,1,0,0,0,0,0,0,0,0,0,1,0,1,0
957,18,NAYARIT,18017,TEPIC,138,19,119,0,0,0,0,0,0,0,0,0,138,19,119,0
958,18,NAYARIT,18018,TUXPAN,0,0,0,0,0,0,0,0,0,0,0,0,0,0,0,0
959,18,NAYARIT,18019,LA YESCA,0,0,0,0,0,0,0,0,0,0,0,0,0,0,0,0
960,18,NAYARIT,18020,BAHIA DE BANDERAS,11,2,9,0,0,0,0,0,0,0,0,0,11,2,9,0
961,19,NUEVO LEON,19001,ABASOLO,1,0,1,0,0,0,0,0,0,0,0,0,1,0,1,0
962,19,NUEVO LEON,19002,AGUALEGUAS,0,0,0,0,0,0,0,0,0,0,0,0,0,0,0,0
963,19,NUEVO LEON,19003,LOS ALDAMAS,4,1,3,0,0,0,0,0,0,0,0,0,4,1,3,0
964,19,NUEVO LEON,19004,ALLENDE,0,0,0,0,0,0,0,0,0,0,0,0,0,0,0,0
965,19,NUEVO LEON,19005,ANAHUAC,3,2,1,0,0,0,0,0,0,0,0,0,3,2,1,0
966,19,NUEVO LEON,19006,APODACA,68,10,58,0,5,0,5,0,0,0,0,0,63,10,53,0
967,19,NUEVO LEON,19007,ARAMBERRI,0,0,0,0,0,0,0,0,0,0,0,0,0,0,0,0
968,19,NUEVO LEON,19008,BUSTAMANTE,0,0,0,0,0,0,0,0,0,0,0,0,0,0,0,0
969,19,NUEVO LEON,19009,CADEREYTA JIMENEZ,66,18,48,0,0,0,0,0,0,0,0,0,66,18,48,0
970,19,NUEVO LEON,19010,EL CARMEN,11,0,11,0,0,0,0,0,0,0,0,0,11,0,11,0
971,19,NUEVO LEON,19011,CERRALVO,0,0,0,0,0,0,0,0,0,0,0,0,0,0,0,0
972,19,NUEVO LEON,19012,CIENEGA DE FLORES,9,6,3,0,0,0,0,0,0,0,0,0,9,6,3,0
973,19,NUEVO LEON,19013,CHINA,20,3,17,0,0,0,0,0,0,0,0,0,20,3,17,0
974,19,NUEVO LEON,19014,DOCTOR ARROYO,25,14,11,0,0,0,0,0,0,0,0,0,25,14,11,0
975,19,NUEVO LEON,19015,DOCTOR COSS,1,1,0,0,0,0,0,0,0,0,0,0,1,1,0,0
976,19,NUEVO LEON,19016,DOCTOR GONZALEZ,2,0,2,0,0,0,0,0,0,0,0,0,2,0,2,0
977,19,NUEVO LEON,19017,GALEANA,40,6,34,0,0,0,0,0,0,0,0,0,40,6,34,0
978,19,NUEVO LEON,19018,GARCIA,24,9,15,0,0,0,0,0,0,0,0,0,24,9,15,0
979,19,NUEVO LEON,19019,SAN PEDRO GARZA GARCIA,0,0,0,0,0,0,0,0,0,0,0,0,0,0,0,0
980,19,NUEVO LEON,19020,GENERAL BRAVO,36,9,27,0,0,0,0,0,0,0,0,0,36,9,27,0
981,19,NUEVO LEON,19021,GENERAL ESCOBEDO,20,11,9,0,0,0,0,0,0,0,0,0,20,11,9,0
982,19,NUEVO LEON,19022,GENERAL TERAN,3,0,3,0,0,0,0,0,0,0,0,0,3,0,3,0
983,19,NUEVO LEON,19023,GENERAL TREVIÑO,0,0,0,0,0,0,0,0,0,0,0,0,0,0,0,0
984,19,NUEVO LEON,19024,GENERAL ZARAGOZA,0,0,0,0,0,0,0,0,0,0,0,0,0,0,0,0
985,19,NUEVO LEON,19025,GENERAL ZUAZUA,0,0,0,0,0,0,0,0,0,0,0,0,0,0,0,0
986,19,NUEVO LEON,19026,GUADALUPE,1,0,1,0,0,0,0,0,0,0,0,0,1,0,1,0
987,19,NUEVO LEON,19027,LOS HERRERAS,0,0,0,0,0,0,0,0,0,0,0,0,0,0,0,0
988,19,NUEVO LEON,19028,HIGUERAS,0,0,0,0,0,0,0,0,0,0,0,0,0,0,0,0
989,19,NUEVO LEON,19029,HUALAHUISES,0,0,0,0,0,0,0,0,0,0,0,0,0,0,0,0
990,19,NUEVO LEON,19030,ITURBIDE,0,0,0,0,0,0,0,0,0,0,0,0,0,0,0,0
991,19,NUEVO LEON,19031,JUAREZ,3,0,3,0,0,0,0,0,0,0,0,0,3,0,3,0
992,19,NUEVO LEON,19032,LAMPAZOS DE NARANJO,0,0,0,0,0,0,0,0,0,0,0,0,0,0,0,0
993,19,NUEVO LEON,19033,LINARES,21,2,19,0,0,0,0,0,0,0,0,0,21,2,19,0
994,19,NUEVO LEON,19034,MARIN,0,0,0,0,0,0,0,0,0,0,0,0,0,0,0,0
995,19,NUEVO LEON,19035,MELCHOR OCAMPO,0,0,0,0,0,0,0,0,0,0,0,0,0,0,0,0
996,19,NUEVO LEON,19036,MIER Y NORIEGA,0,0,0,0,0,0,0,0,0,0,0,0,0,0,0,0
997,19,NUEVO LEON,19037,MINA,30,4,26,0,0,0,0,0,0,0,0,0,30,4,26,0
998,19,NUEVO LEON,19038,MONTEMORELOS,5,2,3,0,0,0,0,0,0,0,0,0,5,2,3,0
999,19,NUEVO LEON,19039,MONTERREY,2,1,1,0,0,0,0,0,0,0,0,0,2,1,1,0
1000,19,NUEVO LEON,19040,PARAS,3,3,0,0,0,0,0,0,0,0,0,0,3,3,0,0
1001,19,NUEVO LEON,19041,PESQUERIA,6,1,5,0,0,0,0,0,0,0,0,0,6,1,5,0
1002,19,NUEVO LEON,19042,LOS RAMONES,17,1,16,0,0,0,0,0,0,0,0,0,17,1,16,0
1003,19,NUEVO LEON,19043,RAYONES,0,0,0,0,0,0,0,0,0,0,0,0,0,0,0,0
1004,19,NUEVO LEON,19044,SABINAS HIDALGO,14,10,4,0,0,0,0,0,0,0,0,0,14,10,4,0
1005,19,NUEVO LEON,19045,SALINAS VICTORIA,0,0,0,0,0,0,0,0,0,0,0,0,0,0,0,0
1006,19,NUEVO LEON,19046,SAN NICOLAS DE LOS GARZA,1,1,0,0,0,0,0,0,0,0,0,0,1,1,0,0
1007,19,NUEVO LEON,19047,HIDALGO,0,0,0,0,0,0,0,0,0,0,0,0,0,0,0,0
1008,19,NUEVO LEON,19048,SANTA CATARINA,42,5,37,0,0,0,0,0,0,0,0,0,42,5,37,0
1009,19,NUEVO LEON,19049,SANTIAGO,2,2,0,0,0,0,0,0,0,0,0,0,2,2,0,0
1010,19,NUEVO LEON,19050,VALLECILLO,7,4,3,0,0,0,0,0,0,0,0,0,7,4,3,0
1011,19,NUEVO LEON,19051,VILLALDAMA,0,0,0,0,0,0,0,0,0,0,0,0,0,0,0,0
1012,20,OAXACA,20001,ABEJONES,0,0,0,0,0,0,0,0,0,0,0,0,0,0,0,0
1013,20,OAXACA,20002,ACATLAN DE PEREZ FIGUEROA,0,0,0,0,0,0,0,0,0,0,0,0,0,0,0,0
1014,20,OAXACA,20003,ASUNCION CACALOTEPEC,0,0,0,0,0,0,0,0,0,0,0,0,0,0,0,0
1015,20,OAXACA,20004,ASUNCION CUYOTEPEJI,0,0,0,0,0,0,0,0,0,0,0,0,0,0,0,0
1016,20,OAXACA,20005,ASUNCION IXTALTEPEC,1,0,1,0,0,0,0,0,0,0,0,0,1,0,1,0
1017,20,OAXACA,20006,ASUNCION NOCHIXTLAN,3,2,1,0,0,0,0,0,0,0,0,0,3,2,1,0
1018,20,OAXACA,20007,ASUNCION OCOTLAN,0,0,0,0,0,0,0,0,0,0,0,0,0,0,0,0
1019,20,OAXACA,20008,ASUNCION TLACOLULITA,0,0,0,0,0,0,0,0,0,0,0,0,0,0,0,0
1020,20,OAXACA,20009,AYOTZINTEPEC,0,0,0,0,0,0,0,0,0,0,0,0,0,0,0,0
1021,20,OAXACA,20010,EL BARRIO DE LA SOLEDAD,25,5,20,0,0,0,0,0,0,0,0,0,25,5,20,0
1022,20,OAXACA,20011,CALIHUALA,0,0,0,0,0,0,0,0,0,0,0,0,0,0,0,0
1023,20,OAXACA,20012,CANDELARIA LOXICHA,1,0,1,0,0,0,0,0,0,0,0,0,1,0,1,0
1024,20,OAXACA,20013,CIENEGA DE ZIMATLAN,0,0,0,0,0,0,0,0,0,0,0,0,0,0,0,0
1025,20,OAXACA,20014,CIUDAD IXTEPEC,14,3,11,0,0,0,0,0,0,0,0,0,14,3,11,0
1026,20,OAXACA,20015,COATECAS ALTAS,0,0,0,0,0,0,0,0,0,0,0,0,0,0,0,0
1027,20,OAXACA,20016,COICOYAN DE LAS FLORES,0,0,0,0,0,0,0,0,0,0,0,0,0,0,0,0
1028,20,OAXACA,20017,LA COMPAÑIA,0,0,0,0,0,0,0,0,0,0,0,0,0,0,0,0
1029,20,OAXACA,20018,CONCEPCION BUENAVISTA,0,0,0,0,0,0,0,0,0,0,0,0,0,0,0,0
1030,20,OAXACA,20019,CONCEPCION PAPALO,0,0,0,0,0,0,0,0,0,0,0,0,0,0,0,0
1031,20,OAXACA,20020,CONSTANCIA DEL ROSARIO,0,0,0,0,0,0,0,0,0,0,0,0,0,0,0,0
1032,20,OAXACA,20021,COSOLAPA,0,0,0,0,0,0,0,0,0,0,0,0,0,0,0,0
1033,20,OAXACA,20022,COSOLTEPEC,0,0,0,0,0,0,0,0,0,0,0,0,0,0,0,0
1034,20,OAXACA,20023,CUILAPAM DE GUERRERO,0,0,0,0,0,0,0,0,0,0,0,0,0,0,0,0
1035,20,OAXACA,20024,CUYAMECALCO VILLA DE ZARAGOZA,0,0,0,0,0,0,0,0,0,0,0,0,0,0,0,0
1036,20,OAXACA,20025,CHAHUITES,0,0,0,0,0,0,0,0,0,0,0,0,0,0,0,0
1037,20,OAXACA,20026,CHALCATONGO DE HIDALGO,0,0,0,0,0,0,0,0,0,0,0,0,0,0,0,0
1038,20,OAXACA,20027,CHIQUIHUITLAN DE BENITO JUAREZ,0,0,0,0,0,0,0,0,0,0,0,0,0,0,0,0
1039,20,OAXACA,20028,HEROICA CIUDAD DE EJUTLA DE CRESPO,2,0,2,0,0,0,0,0,0,0,0,0,2,0,2,0
1040,20,OAXACA,20029,ELOXOCHITLAN DE FLORES MAGON,0,0,0,0,0,0,0,0,0,0,0,0,0,0,0,0
1041,20,OAXACA,20030,EL ESPINAL,0,0,0,0,0,0,0,0,0,0,0,0,0,0,0,0
1042,20,OAXACA,20031,TAMAZULAPAM DEL ESPIRITU SANTO,0,0,0,0,0,0,0,0,0,0,0,0,0,0,0,0
1043,20,OAXACA,20032,FRESNILLO DE TRUJANO,0,0,0,0,0,0,0,0,0,0,0,0,0,0,0,0
1044,20,OAXACA,20033,GUADALUPE ETLA,0,0,0,0,0,0,0,0,0,0,0,0,0,0,0,0
1045,20,OAXACA,20034,GUADALUPE DE RAMIREZ,0,0,0,0,0,0,0,0,0,0,0,0,0,0,0,0
1046,20,OAXACA,20035,GUELATAO DE JUAREZ,0,0,0,0,0,0,0,0,0,0,0,0,0,0,0,0
1047,20,OAXACA,20036,GUEVEA DE HUMBOLDT,0,0,0,0,0,0,0,0,0,0,0,0,0,0,0,0
1048,20,OAXACA,20037,MESONES HIDALGO,0,0,0,0,0,0,0,0,0,0,0,0,0,0,0,0
1049,20,OAXACA,20038,VILLA HIDALGO,0,0,0,0,0,0,0,0,0,0,0,0,0,0,0,0
1050,20,OAXACA,20039,HEROICA CIUDAD DE HUAJUAPAN DE LEON,2,0,2,0,0,0,0,0,0,0,0,0,2,0,2,0
1051,20,OAXACA,20040,HUAUTEPEC,0,0,0,0,0,0,0,0,0,0,0,0,0,0,0,0
1052,20,OAXACA,20041,HUAUTLA DE JIMENEZ,0,0,0,0,0,0,0,0,0,0,0,0,0,0,0,0
1053,20,OAXACA,20042,IXTLAN DE JUAREZ,0,0,0,0,0,0,0,0,0,0,0,0,0,0,0,0
1054,20,OAXACA,20043,JUCHITAN DE ZARAGOZA,12,5,7,0,0,0,0,0,0,0,0,0,12,5,7,0
1055,20,OAXACA,20044,LOMA BONITA,3,0,3,0,0,0,0,0,0,0,0,0,3,0,3,0
1056,20,OAXACA,20045,MAGDALENA APASCO,1,0,1,0,0,0,0,0,0,0,0,0,1,0,1,0
1057,20,OAXACA,20046,MAGDALENA JALTEPEC,0,0,0,0,0,0,0,0,0,0,0,0,0,0,0,0
1058,20,OAXACA,20047,SANTA MAGDALENA JICOTLAN,0,0,0,0,0,0,0,0,0,0,0,0,0,0,0,0
1059,20,OAXACA,20048,MAGDALENA MIXTEPEC,0,0,0,0,0,0,0,0,0,0,0,0,0,0,0,0
1060,20,OAXACA,20049,MAGDALENA OCOTLAN,0,0,0,0,0,0,0,0,0,0,0,0,0,0,0,0
1061,20,OAXACA,20050,MAGDALENA PEÑASCO,0,0,0,0,0,0,0,0,0,0,0,0,0,0,0,0
1062,20,OAXACA,20051,MAGDALENA TEITIPAC,0,0,0,0,0,0,0,0,0,0,0,0,0,0,0,0
1063,20,OAXACA,20052,MAGDALENA TEQUISISTLAN,1,0,1,0,0,0,0,0,0,0,0,0,1,0,1,0
1064,20,OAXACA,20053,MAGDALENA TLACOTEPEC,0,0,0,0,0,0,0,0,0,0,0,0,0,0,0,0
1065,20,OAXACA,20054,MAGDALENA ZAHUATLAN,0,0,0,0,0,0,0,0,0,0,0,0,0,0,0,0
1066,20,OAXACA,20055,MARISCALA DE JUAREZ,0,0,0,0,0,0,0,0,0,0,0,0,0,0,0,0
1067,20,OAXACA,20056,MARTIRES DE TACUBAYA,0,0,0,0,0,0,0,0,0,0,0,0,0,0,0,0
1068,20,OAXACA,20057,MATIAS ROMERO AVENDAÑO,42,15,27,0,0,0,0,0,0,0,0,0,42,15,27,0
1069,20,OAXACA,20058,MAZATLAN VILLA DE FLORES,0,0,0,0,0,0,0,0,0,0,0,0,0,0,0,0
1070,20,OAXACA,20059,MIAHUATLAN DE PORFIRIO DIAZ,0,0,0,0,0,0,0,0,0,0,0,0,0,0,0,0
1071,20,OAXACA,20060,MIXISTLAN DE LA REFORMA,0,0,0,0,0,0,0,0,0,0,0,0,0,0,0,0
1072,20,OAXACA,20061,MONJAS,0,0,0,0,0,0,0,0,0,0,0,0,0,0,0,0
1073,20,OAXACA,20062,NATIVIDAD,0,0,0,0,0,0,0,0,0,0,0,0,0,0,0,0
1074,20,OAXACA,20063,NAZARENO ETLA,0,0,0,0,0,0,0,0,0,0,0,0,0,0,0,0
1075,20,OAXACA,20064,NEJAPA DE MADERO,0,0,0,0,0,0,0,0,0,0,0,0,0,0,0,0
1076,20,OAXACA,20065,IXPANTEPEC NIEVES,0,0,0,0,0,0,0,0,0,0,0,0,0,0,0,0
1077,20,OAXACA,20066,SANTIAGO NILTEPEC,0,0,0,0,0,0,0,0,0,0,0,0,0,0,0,0
1078,20,OAXACA,20067,OAXACA DE JUAREZ,0,0,0,0,0,0,0,0,0,0,0,0,0,0,0,0
1079,20,OAXACA,20068,OCOTLAN DE MORELOS,0,0,0,0,0,0,0,0,0,0,0,0,0,0,0,0
1080,20,OAXACA,20069,LA PE,0,0,0,0,0,0,0,0,0,0,0,0,0,0,0,0
1081,20,OAXACA,20070,PINOTEPA DE DON LUIS,0,0,0,0,0,0,0,0,0,0,0,0,0,0,0,0
1082,20,OAXACA,20071,PLUMA HIDALGO,0,0,0,0,0,0,0,0,0,0,0,0,0,0,0,0
1083,20,OAXACA,20072,SAN JOSE DEL PROGRESO,0,0,0,0,0,0,0,0,0,0,0,0,0,0,0,0
1084,20,OAXACA,20073,PUTLA VILLA DE GUERRERO,0,0,0,0,0,0,0,0,0,0,0,0,0,0,0,0
1085,20,OAXACA,20074,SANTA CATARINA QUIOQUITANI,0,0,0,0,0,0,0,0,0,0,0,0,0,0,0,0
1086,20,OAXACA,20075,REFORMA DE PINEDA,1,1,0,0,0,0,0,0,0,0,0,0,1,1,0,0
1087,20,OAXACA,20076,LA REFORMA,0,0,0,0,0,0,0,0,0,0,0,0,0,0,0,0
1088,20,OAXACA,20077,REYES ETLA,0,0,0,0,0,0,0,0,0,0,0,0,0,0,0,0
1089,20,OAXACA,20078,ROJAS DE CUAUHTEMOC,0,0,0,0,0,0,0,0,0,0,0,0,0,0,0,0
1090,20,OAXACA,20079,SALINA CRUZ,1,0,1,0,0,0,0,0,0,0,0,0,1,0,1,0
1091,20,OAXACA,20080,SAN AGUSTIN AMATENGO,0,0,0,0,0,0,0,0,0,0,0,0,0,0,0,0
1092,20,OAXACA,20081,SAN AGUSTIN ATENANGO,0,0,0,0,0,0,0,0,0,0,0,0,0,0,0,0
1093,20,OAXACA,20082,SAN AGUSTIN CHAYUCO,0,0,0,0,0,0,0,0,0,0,0,0,0,0,0,0
1094,20,OAXACA,20083,SAN AGUSTIN DE LAS JUNTAS,0,0,0,0,0,0,0,0,0,0,0,0,0,0,0,0
1095,20,OAXACA,20084,SAN AGUSTIN ETLA,0,0,0,0,0,0,0,0,0,0,0,0,0,0,0,0
1096,20,OAXACA,20085,SAN AGUSTIN LOXICHA,0,0,0,0,0,0,0,0,0,0,0,0,0,0,0,0
1097,20,OAXACA,20086,SAN AGUSTIN TLACOTEPEC,0,0,0,0,0,0,0,0,0,0,0,0,0,0,0,0
1098,20,OAXACA,20087,SAN AGUSTIN YATARENI,0,0,0,0,0,0,0,0,0,0,0,0,0,0,0,0
1099,20,OAXACA,20088,SAN ANDRES CABECERA NUEVA,0,0,0,0,0,0,0,0,0,0,0,0,0,0,0,0
1100,20,OAXACA,20089,SAN ANDRES DINICUITI,0,0,0,0,0,0,0,0,0,0,0,0,0,0,0,0
1101,20,OAXACA,20090,SAN ANDRES HUAXPALTEPEC,2,0,2,0,0,0,0,0,0,0,0,0,2,0,2,0
1102,20,OAXACA,20091,SAN ANDRES HUAYAPAM,0,0,0,0,0,0,0,0,0,0,0,0,0,0,0,0
1103,20,OAXACA,20092,SAN ANDRES IXTLAHUACA,0,0,0,0,0,0,0,0,0,0,0,0,0,0,0,0
1104,20,OAXACA,20093,SAN ANDRES LAGUNAS,0,0,0,0,0,0,0,0,0,0,0,0,0,0,0,0
1105,20,OAXACA,20094,SAN ANDRES NUXIÑO,0,0,0,0,0,0,0,0,0,0,0,0,0,0,0,0
1106,20,OAXACA,20095,SAN ANDRES PAXTLAN,0,0,0,0,0,0,0,0,0,0,0,0,0,0,0,0
1107,20,OAXACA,20096,SAN ANDRES SINAXTLA,0,0,0,0,0,0,0,0,0,0,0,0,0,0,0,0
1108,20,OAXACA,20097,SAN ANDRES SOLAGA,0,0,0,0,0,0,0,0,0,0,0,0,0,0,0,0
1109,20,OAXACA,20098,SAN ANDRES TEOTILALPAM,0,0,0,0,0,0,0,0,0,0,0,0,0,0,0,0
1110,20,OAXACA,20099,SAN ANDRES TEPETLAPA,0,0,0,0,0,0,0,0,0,0,0,0,0,0,0,0
1111,20,OAXACA,20100,SAN ANDRES YAA,0,0,0,0,0,0,0,0,0,0,0,0,0,0,0,0
1112,20,OAXACA,20101,SAN ANDRES ZABACHE,0,0,0,0,0,0,0,0,0,0,0,0,0,0,0,0
1113,20,OAXACA,20102,SAN ANDRES ZAUTLA,1,1,0,0,0,0,0,0,0,0,0,0,1,1,0,0
1114,20,OAXACA,20103,SAN ANTONINO CASTILLO VELASCO,0,0,0,0,0,0,0,0,0,0,0,0,0,0,0,0
1115,20,OAXACA,20104,SAN ANTONINO EL ALTO,0,0,0,0,0,0,0,0,0,0,0,0,0,0,0,0
1116,20,OAXACA,20105,SAN ANTONINO MONTE VERDE,0,0,0,0,0,0,0,0,0,0,0,0,0,0,0,0
1117,20,OAXACA,20106,SAN ANTONIO ACUTLA,0,0,0,0,0,0,0,0,0,0,0,0,0,0,0,0
1118,20,OAXACA,20107,SAN ANTONIO DE LA CAL,1,1,0,0,0,0,0,0,0,0,0,0,1,1,0,0
1119,20,OAXACA,20108,SAN ANTONIO HUITEPEC,0,0,0,0,0,0,0,0,0,0,0,0,0,0,0,0
1120,20,OAXACA,20109,SAN ANTONIO NANAHUATIPAM,0,0,0,0,0,0,0,0,0,0,0,0,0,0,0,0
1121,20,OAXACA,20110,SAN ANTONIO SINICAHUA,0,0,0,0,0,0,0,0,0,0,0,0,0,0,0,0
1122,20,OAXACA,20111,SAN ANTONIO TEPETLAPA,0,0,0,0,0,0,0,0,0,0,0,0,0,0,0,0
1123,20,OAXACA,20112,SAN BALTAZAR CHICHICAPAM,0,0,0,0,0,0,0,0,0,0,0,0,0,0,0,0
1124,20,OAXACA,20113,SAN BALTAZAR LOXICHA,0,0,0,0,0,0,0,0,0,0,0,0,0,0,0,0
1125,20,OAXACA,20114,SAN BALTAZAR YATZACHI EL BAJO,0,0,0,0,0,0,0,0,0,0,0,0,0,0,0,0
1126,20,OAXACA,20115,SAN BARTOLO COYOTEPEC,0,0,0,0,0,0,0,0,0,0,0,0,0,0,0,0
1127,20,OAXACA,20116,SAN BARTOLOME AYAUTLA,0,0,0,0,0,0,0,0,0,0,0,0,0,0,0,0
1128,20,OAXACA,20117,SAN BARTOLOME LOXICHA,0,0,0,0,0,0,0,0,0,0,0,0,0,0,0,0
1129,20,OAXACA,20118,SAN BARTOLOME QUIALANA,0,0,0,0,0,0,0,0,0,0,0,0,0,0,0,0
1130,20,OAXACA,20119,SAN BARTOLOME YUCUAÑE,0,0,0,0,0,0,0,0,0,0,0,0,0,0,0,0
1131,20,OAXACA,20120,SAN BARTOLOME ZOOGOCHO,0,0,0,0,0,0,0,0,0,0,0,0,0,0,0,0
1132,20,OAXACA,20121,SAN BARTOLO SOYALTEPEC,0,0,0,0,0,0,0,0,0,0,0,0,0,0,0,0
1133,20,OAXACA,20122,SAN BARTOLO YAUTEPEC,0,0,0,0,0,0,0,0,0,0,0,0,0,0,0,0
1134,20,OAXACA,20123,SAN BERNARDO MIXTEPEC,0,0,0,0,0,0,0,0,0,0,0,0,0,0,0,0
1135,20,OAXACA,20124,SAN BLAS ATEMPA,0,0,0,0,0,0,0,0,0,0,0,0,0,0,0,0
1136,20,OAXACA,20125,SAN CARLOS YAUTEPEC,0,0,0,0,0,0,0,0,0,0,0,0,0,0,0,0
1137,20,OAXACA,20126,SAN CRISTOBAL AMATLAN,0,0,0,0,0,0,0,0,0,0,0,0,0,0,0,0
1138,20,OAXACA,20127,SAN CRISTOBAL AMOLTEPEC,0,0,0,0,0,0,0,0,0,0,0,0,0,0,0,0
1139,20,OAXACA,20128,SAN CRISTOBAL LACHIRIOAG,0,0,0,0,0,0,0,0,0,0,0,0,0,0,0,0
1140,20,OAXACA,20129,SAN CRISTOBAL SUCHIXTLAHUACA,7,3,4,0,0,0,0,0,0,0,0,0,7,3,4,0
1141,20,OAXACA,20130,SAN DIONISIO DEL MAR,0,0,0,0,0,0,0,0,0,0,0,0,0,0,0,0
1142,20,OAXACA,20131,SAN DIONISIO OCOTEPEC,13,1,12,0,0,0,0,0,0,0,0,0,13,1,12,0
1143,20,OAXACA,20132,SAN DIONISIO OCOTLAN,0,0,0,0,0,0,0,0,0,0,0,0,0,0,0,0
1144,20,OAXACA,20133,SAN ESTEBAN ATATLAHUCA,0,0,0,0,0,0,0,0,0,0,0,0,0,0,0,0
1145,20,OAXACA,20134,SAN FELIPE JALAPA DE DIAZ,0,0,0,0,0,0,0,0,0,0,0,0,0,0,0,0
1146,20,OAXACA,20135,SAN FELIPE TEJALAPAM,0,0,0,0,0,0,0,0,0,0,0,0,0,0,0,0
1147,20,OAXACA,20136,SAN FELIPE USILA,0,0,0,0,0,0,0,0,0,0,0,0,0,0,0,0
1148,20,OAXACA,20137,SAN FRANCISCO CAHUACUA,0,0,0,0,0,0,0,0,0,0,0,0,0,0,0,0
1149,20,OAXACA,20138,SAN FRANCISCO CAJONOS,0,0,0,0,0,0,0,0,0,0,0,0,0,0,0,0
1150,20,OAXACA,20139,SAN FRANCISCO CHAPULAPA,0,0,0,0,0,0,0,0,0,0,0,0,0,0,0,0
1151,20,OAXACA,20140,SAN FRANCISCO CHINDUA,0,0,0,0,0,0,0,0,0,0,0,0,0,0,0,0
1152,20,OAXACA,20141,SAN FRANCISCO DEL MAR,0,0,0,0,0,0,0,0,0,0,0,0,0,0,0,0
1153,20,OAXACA,20142,SAN FRANCISCO HUEHUETLAN,0,0,0,0,0,0,0,0,0,0,0,0,0,0,0,0
1154,20,OAXACA,20143,SAN FRANCISCO IXHUATAN,0,0,0,0,0,0,0,0,0,0,0,0,0,0,0,0
1155,20,OAXACA,20144,SAN FRANCISCO JALTEPETONGO,0,0,0,0,0,0,0,0,0,0,0,0,0,0,0,0
1156,20,OAXACA,20145,SAN FRANCISCO LACHIGOLO,0,0,0,0,0,0,0,0,0,0,0,0,0,0,0,0
1157,20,OAXACA,20146,SAN FRANCISCO LOGUECHE,0,0,0,0,0,0,0,0,0,0,0,0,0,0,0,0
1158,20,OAXACA,20147,SAN FRANCISCO NUXAÑO,0,0,0,0,0,0,0,0,0,0,0,0,0,0,0,0
1159,20,OAXACA,20148,SAN FRANCISCO OZOLOTEPEC,0,0,0,0,0,0,0,0,0,0,0,0,0,0,0,0
1160,20,OAXACA,20149,SAN FRANCISCO SOLA,0,0,0,0,0,0,0,0,0,0,0,0,0,0,0,0
1161,20,OAXACA,20150,SAN FRANCISCO TELIXTLAHUACA,4,0,4,0,0,0,0,0,0,0,0,0,4,0,4,0
1162,20,OAXACA,20151,SAN FRANCISCO TEOPAN,0,0,0,0,0,0,0,0,0,0,0,0,0,0,0,0
1163,20,OAXACA,20152,SAN FRANCISCO TLAPANCINGO,0,0,0,0,0,0,0,0,0,0,0,0,0,0,0,0
1164,20,OAXACA,20153,SAN GABRIEL MIXTEPEC,0,0,0,0,0,0,0,0,0,0,0,0,0,0,0,0
1165,20,OAXACA,20154,SAN ILDEFONSO AMATLAN,0,0,0,0,0,0,0,0,0,0,0,0,0,0,0,0
1166,20,OAXACA,20155,SAN ILDEFONSO SOLA,0,0,0,0,0,0,0,0,0,0,0,0,0,0,0,0
1167,20,OAXACA,20156,SAN ILDEFONSO VILLA ALTA,0,0,0,0,0,0,0,0,0,0,0,0,0,0,0,0
1168,20,OAXACA,20157,SAN JACINTO AMILPAS,1,1,0,0,0,0,0,0,0,0,0,0,1,1,0,0
1169,20,OAXACA,20158,SAN JACINTO TLACOTEPEC,0,0,0,0,0,0,0,0,0,0,0,0,0,0,0,0
1170,20,OAXACA,20159,SAN JERONIMO COATLAN,0,0,0,0,0,0,0,0,0,0,0,0,0,0,0,0
1171,20,OAXACA,20160,SAN JERONIMO SILACAYOAPILLA,0,0,0,0,0,0,0,0,0,0,0,0,0,0,0,0
1172,20,OAXACA,20161,SAN JERONIMO SOSOLA,0,0,0,0,0,0,0,0,0,0,0,0,0,0,0,0
1173,20,OAXACA,20162,SAN JERONIMO TAVICHE,0,0,0,0,0,0,0,0,0,0,0,0,0,0,0,0
1174,20,OAXACA,20163,SAN JERONIMO TECOATL,0,0,0,0,0,0,0,0,0,0,0,0,0,0,0,0
1175,20,OAXACA,20164,SAN JORGE NUCHITA,0,0,0,0,0,0,0,0,0,0,0,0,0,0,0,0
1176,20,OAXACA,20165,SAN JOSE AYUQUILA,0,0,0,0,0,0,0,0,0,0,0,0,0,0,0,0
1177,20,OAXACA,20166,SAN JOSE CHILTEPEC,0,0,0,0,0,0,0,0,0,0,0,0,0,0,0,0
1178,20,OAXACA,20167,SAN JOSE DEL PEÑASCO,0,0,0,0,0,0,0,0,0,0,0,0,0,0,0,0
1179,20,OAXACA,20168,SAN JOSE ESTANCIA GRANDE,1,1,0,0,0,0,0,0,0,0,0,0,1,1,0,0
1180,20,OAXACA,20169,SAN JOSE INDEPENDENCIA,0,0,0,0,0,0,0,0,0,0,0,0,0,0,0,0
1181,20,OAXACA,20170,SAN JOSE LACHIGUIRI,0,0,0,0,0,0,0,0,0,0,0,0,0,0,0,0
1182,20,OAXACA,20171,SAN JOSE TENANGO,0,0,0,0,0,0,0,0,0,0,0,0,0,0,0,0
1183,20,OAXACA,20172,SAN JUAN ACHIUTLA,0,0,0,0,0,0,0,0,0,0,0,0,0,0,0,0
1184,20,OAXACA,20173,SAN JUAN ATEPEC,0,0,0,0,0,0,0,0,0,0,0,0,0,0,0,0
1185,20,OAXACA,20174,ANIMAS TRUJANO,0,0,0,0,0,0,0,0,0,0,0,0,0,0,0,0
1186,20,OAXACA,20175,SAN JUAN BAUTISTA ATATLAHUCA,0,0,0,0,0,0,0,0,0,0,0,0,0,0,0,0
1187,20,OAXACA,20176,SAN JUAN BAUTISTA COIXTLAHUACA,5,1,4,0,0,0,0,0,0,0,0,0,5,1,4,0
1188,20,OAXACA,20177,SAN JUAN BAUTISTA CUICATLAN,0,0,0,0,0,0,0,0,0,0,0,0,0,0,0,0
1189,20,OAXACA,20178,SAN JUAN BAUTISTA GUELACHE,0,0,0,0,0,0,0,0,0,0,0,0,0,0,0,0
1190,20,OAXACA,20179,SAN JUAN BAUTISTA JAYACATLAN,0,0,0,0,0,0,0,0,0,0,0,0,0,0,0,0
1191,20,OAXACA,20180,SAN JUAN BAUTISTA LO DE SOTO,0,0,0,0,0,0,0,0,0,0,0,0,0,0,0,0
1192,20,OAXACA,20181,SAN JUAN BAUTISTA SUCHITEPEC,0,0,0,0,0,0,0,0,0,0,0,0,0,0,0,0
1193,20,OAXACA,20182,SAN JUAN BAUTISTA TLACOATZINTEPEC,0,0,0,0,0,0,0,0,0,0,0,0,0,0,0,0
1194,20,OAXACA,20183,SAN JUAN BAUTISTA TLACHICHILCO,0,0,0,0,0,0,0,0,0,0,0,0,0,0,0,0
1195,20,OAXACA,20184,SAN JUAN BAUTISTA TUXTEPEC,11,3,8,0,0,0,0,0,0,0,0,0,11,3,8,0
1196,20,OAXACA,20185,SAN JUAN CACAHUATEPEC,0,0,0,0,0,0,0,0,0,0,0,0,0,0,0,0
1197,20,OAXACA,20186,SAN JUAN CIENEGUILLA,0,0,0,0,0,0,0,0,0,0,0,0,0,0,0,0
1198,20,OAXACA,20187,SAN JUAN COATZOSPAM,0,0,0,0,0,0,0,0,0,0,0,0,0,0,0,0
1199,20,OAXACA,20188,SAN JUAN COLORADO,0,0,0,0,0,0,0,0,0,0,0,0,0,0,0,0
1200,20,OAXACA,20189,SAN JUAN COMALTEPEC,0,0,0,0,0,0,0,0,0,0,0,0,0,0,0,0
1201,20,OAXACA,20190,SAN JUAN COTZOCON,0,0,0,0,0,0,0,0,0,0,0,0,0,0,0,0
1202,20,OAXACA,20191,SAN JUAN CHICOMEZUCHIL,0,0,0,0,0,0,0,0,0,0,0,0,0,0,0,0
1203,20,OAXACA,20192,SAN JUAN CHILATECA,0,0,0,0,0,0,0,0,0,0,0,0,0,0,0,0
1204,20,OAXACA,20193,SAN JUAN DEL ESTADO,0,0,0,0,0,0,0,0,0,0,0,0,0,0,0,0
1205,20,OAXACA,20194,SAN JUAN DEL RIO,0,0,0,0,0,0,0,0,0,0,0,0,0,0,0,0
1206,20,OAXACA,20195,SAN JUAN DIUXI,0,0,0,0,0,0,0,0,0,0,0,0,0,0,0,0
1207,20,OAXACA,20196,SAN JUAN EVANGELISTA ANALCO,0,0,0,0,0,0,0,0,0,0,0,0,0,0,0,0
1208,20,OAXACA,20197,SAN JUAN GUELAVIA,0,0,0,0,0,0,0,0,0,0,0,0,0,0,0,0
1209,20,OAXACA,20198,SAN JUAN GUICHICOVI,15,0,15,0,0,0,0,0,0,0,0,0,15,0,15,0
1210,20,OAXACA,20199,SAN JUAN IHUALTEPEC,0,0,0,0,0,0,0,0,0,0,0,0,0,0,0,0
1211,20,OAXACA,20200,SAN JUAN JUQUILA MIXES,0,0,0,0,0,0,0,0,0,0,0,0,0,0,0,0
1212,20,OAXACA,20201,SAN JUAN JUQUILA VIJANOS,0,0,0,0,0,0,0,0,0,0,0,0,0,0,0,0
1213,20,OAXACA,20202,SAN JUAN LACHAO,0,0,0,0,0,0,0,0,0,0,0,0,0,0,0,0
1214,20,OAXACA,20203,SAN JUAN LACHIGALLA,0,0,0,0,0,0,0,0,0,0,0,0,0,0,0,0
1215,20,OAXACA,20204,SAN JUAN LAJARCIA,0,0,0,0,0,0,0,0,0,0,0,0,0,0,0,0
1216,20,OAXACA,20205,SAN JUAN LALANA,0,0,0,0,0,0,0,0,0,0,0,0,0,0,0,0
1217,20,OAXACA,20206,SAN JUAN DE LOS CUES,0,0,0,0,0,0,0,0,0,0,0,0,0,0,0,0
1218,20,OAXACA,20207,SAN JUAN MAZATLAN,0,0,0,0,0,0,0,0,0,0,0,0,0,0,0,0
1219,20,OAXACA,20208,SAN JUAN MIXTEPEC,0,0,0,0,0,0,0,0,0,0,0,0,0,0,0,0
1220,20,OAXACA,20209,SAN JUAN MIXTEPEC,0,0,0,0,0,0,0,0,0,0,0,0,0,0,0,0
1221,20,OAXACA,20210,SAN JUAN ÑUMI,0,0,0,0,0,0,0,0,0,0,0,0,0,0,0,0
1222,20,OAXACA,20211,SAN JUAN OZOLOTEPEC,0,0,0,0,0,0,0,0,0,0,0,0,0,0,0,0
1223,20,OAXACA,20212,SAN JUAN PETLAPA,0,0,0,0,0,0,0,0,0,0,0,0,0,0,0,0
1224,20,OAXACA,20213,SAN JUAN QUIAHIJE,0,0,0,0,0,0,0,0,0,0,0,0,0,0,0,0
1225,20,OAXACA,20214,SAN JUAN QUIOTEPEC,0,0,0,0,0,0,0,0,0,0,0,0,0,0,0,0
1226,20,OAXACA,20215,SAN JUAN SAYULTEPEC,0,0,0,0,0,0,0,0,0,0,0,0,0,0,0,0
1227,20,OAXACA,20216,SAN JUAN TABAA,0,0,0,0,0,0,0,0,0,0,0,0,0,0,0,0
1228,20,OAXACA,20217,SAN JUAN TAMAZOLA,0,0,0,0,0,0,0,0,0,0,0,0,0,0,0,0
1229,20,OAXACA,20218,SAN JUAN TEITA,0,0,0,0,0,0,0,0,0,0,0,0,0,0,0,0
1230,20,OAXACA,20219,SAN JUAN TEITIPAC,0,0,0,0,0,0,0,0,0,0,0,0,0,0,0,0
1231,20,OAXACA,20220,SAN JUAN TEPEUXILA,0,0,0,0,0,0,0,0,0,0,0,0,0,0,0,0
1232,20,OAXACA,20221,SAN JUAN TEPOSCOLULA,1,0,1,0,0,0,0,0,0,0,0,0,1,0,1,0
1233,20,OAXACA,20222,SAN JUAN YAEE,0,0,0,0,0,0,0,0,0,0,0,0,0,0,0,0
1234,20,OAXACA,20223,SAN JUAN YATZONA,0,0,0,0,0,0,0,0,0,0,0,0,0,0,0,0
1235,20,OAXACA,20224,SAN JUAN YUCUITA,0,0,0,0,0,0,0,0,0,0,0,0,0,0,0,0
1236,20,OAXACA,20225,SAN LORENZO,0,0,0,0,0,0,0,0,0,0,0,0,0,0,0,0
1237,20,OAXACA,20226,SAN LORENZO ALBARRADAS,0,0,0,0,0,0,0,0,0,0,0,0,0,0,0,0
1238,20,OAXACA,20227,SAN LORENZO CACAOTEPEC,1,1,0,0,0,0,0,0,0,0,0,0,1,1,0,0
1239,20,OAXACA,20228,SAN LORENZO CUAUNECUILTITLA,0,0,0,0,0,0,0,0,0,0,0,0,0,0,0,0
1240,20,OAXACA,20229,SAN LORENZO TEXMELUCAN,0,0,0,0,0,0,0,0,0,0,0,0,0,0,0,0
1241,20,OAXACA,20230,SAN LORENZO VICTORIA,0,0,0,0,0,0,0,0,0,0,0,0,0,0,0,0
1242,20,OAXACA,20231,SAN LUCAS CAMOTLAN,0,0,0,0,0,0,0,0,0,0,0,0,0,0,0,0
1243,20,OAXACA,20232,SAN LUCAS OJITLAN,0,0,0,0,0,0,0,0,0,0,0,0,0,0,0,0
1244,20,OAXACA,20233,SAN LUCAS QUIAVINI,0,0,0,0,0,0,0,0,0,0,0,0,0,0,0,0
1245,20,OAXACA,20234,SAN LUCAS ZOQUIAPAM,0,0,0,0,0,0,0,0,0,0,0,0,0,0,0,0
1246,20,OAXACA,20235,SAN LUIS AMATLAN,0,0,0,0,0,0,0,0,0,0,0,0,0,0,0,0
1247,20,OAXACA,20236,SAN MARCIAL OZOLOTEPEC,0,0,0,0,0,0,0,0,0,0,0,0,0,0,0,0
1248,20,OAXACA,20237,SAN MARCOS ARTEAGA,0,0,0,0,0,0,0,0,0,0,0,0,0,0,0,0
1249,20,OAXACA,20238,SAN MARTIN DE LOS CANSECOS,0,0,0,0,0,0,0,0,0,0,0,0,0,0,0,0
1250,20,OAXACA,20239,SAN MARTIN HUAMELULPAM,0,0,0,0,0,0,0,0,0,0,0,0,0,0,0,0
1251,20,OAXACA,20240,SAN MARTIN ITUNYOSO,0,0,0,0,0,0,0,0,0,0,0,0,0,0,0,0
1252,20,OAXACA,20241,SAN MARTIN LACHILA,0,0,0,0,0,0,0,0,0,0,0,0,0,0,0,0
1253,20,OAXACA,20242,SAN MARTIN PERAS,0,0,0,0,0,0,0,0,0,0,0,0,0,0,0,0
1254,20,OAXACA,20243,SAN MARTIN TILCAJETE,0,0,0,0,0,0,0,0,0,0,0,0,0,0,0,0
1255,20,OAXACA,20244,SAN MARTIN TOXPALAN,0,0,0,0,0,0,0,0,0,0,0,0,0,0,0,0
1256,20,OAXACA,20245,SAN MARTIN ZACATEPEC,0,0,0,0,0,0,0,0,0,0,0,0,0,0,0,0
1257,20,OAXACA,20246,SAN MATEO CAJONOS,0,0,0,0,0,0,0,0,0,0,0,0,0,0,0,0
1258,20,OAXACA,20247,CAPULALPAM DE MENDEZ,0,0,0,0,0,0,0,0,0,0,0,0,0,0,0,0
1259,20,OAXACA,20248,SAN MATEO DEL MAR,0,0,0,0,0,0,0,0,0,0,0,0,0,0,0,0
1260,20,OAXACA,20249,SAN MATEO YOLOXOCHITLAN,0,0,0,0,0,0,0,0,0,0,0,0,0,0,0,0
1261,20,OAXACA,20250,SAN MATEO ETLATONGO,0,0,0,0,0,0,0,0,0,0,0,0,0,0,0,0
1262,20,OAXACA,20251,SAN MATEO NEJAPAM,0,0,0,0,0,0,0,0,0,0,0,0,0,0,0,0
1263,20,OAXACA,20252,SAN MATEO PEÑASCO,0,0,0,0,0,0,0,0,0,0,0,0,0,0,0,0
1264,20,OAXACA,20253,SAN MATEO PIÑAS,0,0,0,0,0,0,0,0,0,0,0,0,0,0,0,0
1265,20,OAXACA,20254,SAN MATEO RIO HONDO,0,0,0,0,0,0,0,0,0,0,0,0,0,0,0,0
1266,20,OAXACA,20255,SAN MATEO SINDIHUI,0,0,0,0,0,0,0,0,0,0,0,0,0,0,0,0
1267,20,OAXACA,20256,SAN MATEO TLAPILTEPEC,0,0,0,0,0,0,0,0,0,0,0,0,0,0,0,0
1268,20,OAXACA,20257,SAN MELCHOR BETAZA,0,0,0,0,0,0,0,0,0,0,0,0,0,0,0,0
1269,20,OAXACA,20258,SAN MIGUEL ACHIUTLA,0,0,0,0,0,0,0,0,0,0,0,0,0,0,0,0
1270,20,OAXACA,20259,SAN MIGUEL AHUEHUETITLAN,0,0,0,0,0,0,0,0,0,0,0,0,0,0,0,0
1271,20,OAXACA,20260,SAN MIGUEL ALOAPAM,0,0,0,0,0,0,0,0,0,0,0,0,0,0,0,0
1272,20,OAXACA,20261,SAN MIGUEL AMATITLAN,0,0,0,0,0,0,0,0,0,0,0,0,0,0,0,0
1273,20,OAXACA,20262,SAN MIGUEL AMATLAN,0,0,0,0,0,0,0,0,0,0,0,0,0,0,0,0
1274,20,OAXACA,20263,SAN MIGUEL COATLAN,0,0,0,0,0,0,0,0,0,0,0,0,0,0,0,0
1275,20,OAXACA,20264,SAN MIGUEL CHICAHUA,0,0,0,0,0,0,0,0,0,0,0,0,0,0,0,0
1276,20,OAXACA,20265,SAN MIGUEL CHIMALAPA,0,0,0,0,0,0,0,0,0,0,0,0,0,0,0,0
1277,20,OAXACA,20266,SAN MIGUEL DEL PUERTO,1,0,1,0,0,0,0,0,0,0,0,0,1,0,1,0
1278,20,OAXACA,20267,SAN MIGUEL DEL RIO,0,0,0,0,0,0,0,0,0,0,0,0,0,0,0,0
1279,20,OAXACA,20268,SAN MIGUEL EJUTLA,0,0,0,0,0,0,0,0,0,0,0,0,0,0,0,0
1280,20,OAXACA,20269,SAN MIGUEL EL GRANDE,0,0,0,0,0,0,0,0,0,0,0,0,0,0,0,0
1281,20,OAXACA,20270,SAN MIGUEL HUAUTLA,0,0,0,0,0,0,0,0,0,0,0,0,0,0,0,0
1282,20,OAXACA,20271,SAN MIGUEL MIXTEPEC,0,0,0,0,0,0,0,0,0,0,0,0,0,0,0,0
1283,20,OAXACA,20272,SAN MIGUEL PANIXTLAHUACA,0,0,0,0,0,0,0,0,0,0,0,0,0,0,0,0
1284,20,OAXACA,20273,SAN MIGUEL PERAS,0,0,0,0,0,0,0,0,0,0,0,0,0,0,0,0
1285,20,OAXACA,20274,SAN MIGUEL PIEDRAS,0,0,0,0,0,0,0,0,0,0,0,0,0,0,0,0
1286,20,OAXACA,20275,SAN MIGUEL QUETZALTEPEC,0,0,0,0,0,0,0,0,0,0,0,0,0,0,0,0
1287,20,OAXACA,20276,SAN MIGUEL SANTA FLOR,0,0,0,0,0,0,0,0,0,0,0,0,0,0,0,0
1288,20,OAXACA,20277,VILLA SOLA DE VEGA,0,0,0,0,0,0,0,0,0,0,0,0,0,0,0,0
1289,20,OAXACA,20278,SAN MIGUEL SOYALTEPEC,0,0,0,0,0,0,0,0,0,0,0,0,0,0,0,0
1290,20,OAXACA,20279,SAN MIGUEL SUCHIXTEPEC,0,0,0,0,0,0,0,0,0,0,0,0,0,0,0,0
1291,20,OAXACA,20280,VILLA TALEA DE CASTRO,0,0,0,0,0,0,0,0,0,0,0,0,0,0,0,0
1292,20,OAXACA,20281,SAN MIGUEL TECOMATLAN,0,0,0,0,0,0,0,0,0,0,0,0,0,0,0,0
1293,20,OAXACA,20282,SAN MIGUEL TENANGO,0,0,0,0,0,0,0,0,0,0,0,0,0,0,0,0
1294,20,OAXACA,20283,SAN MIGUEL TEQUIXTEPEC,0,0,0,0,0,0,0,0,0,0,0,0,0,0,0,0
1295,20,OAXACA,20284,SAN MIGUEL TILQUIAPAM,0,0,0,0,0,0,0,0,0,0,0,0,0,0,0,0
1296,20,OAXACA,20285,SAN MIGUEL TLACAMAMA,0,0,0,0,0,0,0,0,0,0,0,0,0,0,0,0
1297,20,OAXACA,20286,SAN MIGUEL TLACOTEPEC,0,0,0,0,0,0,0,0,0,0,0,0,0,0,0,0
1298,20,OAXACA,20287,SAN MIGUEL TULANCINGO,0,0,0,0,0,0,0,0,0,0,0,0,0,0,0,0
1299,20,OAXACA,20288,SAN MIGUEL YOTAO,0,0,0,0,0,0,0,0,0,0,0,0,0,0,0,0
1300,20,OAXACA,20289,SAN NICOLAS,0,0,0,0,0,0,0,0,0,0,0,0,0,0,0,0
1301,20,OAXACA,20290,SAN NICOLAS HIDALGO,0,0,0,0,0,0,0,0,0,0,0,0,0,0,0,0
1302,20,OAXACA,20291,SAN PABLO COATLAN,0,0,0,0,0,0,0,0,0,0,0,0,0,0,0,0
1303,20,OAXACA,20292,SAN PABLO CUATRO VENADOS,0,0,0,0,0,0,0,0,0,0,0,0,0,0,0,0
1304,20,OAXACA,20293,SAN PABLO ETLA,12,5,7,0,0,0,0,0,0,0,0,0,12,5,7,0
1305,20,OAXACA,20294,SAN PABLO HUITZO,37,15,22,0,0,0,0,0,0,0,0,0,37,15,22,0
1306,20,OAXACA,20295,SAN PABLO HUIXTEPEC,1,0,1,0,0,0,0,0,0,0,0,0,1,0,1,0
1307,20,OAXACA,20296,SAN PABLO MACUILTIANGUIS,0,0,0,0,0,0,0,0,0,0,0,0,0,0,0,0
1308,20,OAXACA,20297,SAN PABLO TIJALTEPEC,0,0,0,0,0,0,0,0,0,0,0,0,0,0,0,0
1309,20,OAXACA,20298,SAN PABLO VILLA DE MITLA,1,1,0,0,0,0,0,0,0,0,0,0,1,1,0,0
1310,20,OAXACA,20299,SAN PABLO YAGANIZA,0,0,0,0,0,0,0,0,0,0,0,0,0,0,0,0
1311,20,OAXACA,20300,SAN PEDRO AMUZGOS,0,0,0,0,0,0,0,0,0,0,0,0,0,0,0,0
1312,20,OAXACA,20301,SAN PEDRO APOSTOL,1,1,0,0,0,0,0,0,0,0,0,0,1,1,0,0
1313,20,OAXACA,20302,SAN PEDRO ATOYAC,0,0,0,0,0,0,0,0,0,0,0,0,0,0,0,0
1314,20,OAXACA,20303,SAN PEDRO CAJONOS,0,0,0,0,0,0,0,0,0,0,0,0,0,0,0,0
1315,20,OAXACA,20304,SAN PEDRO COXCALTEPEC CANTAROS,0,0,0,0,0,0,0,0,0,0,0,0,0,0,0,0
1316,20,OAXACA,20305,SAN PEDRO COMITANCILLO,0,0,0,0,0,0,0,0,0,0,0,0,0,0,0,0
1317,20,OAXACA,20306,SAN PEDRO EL ALTO,0,0,0,0,0,0,0,0,0,0,0,0,0,0,0,0
1318,20,OAXACA,20307,SAN PEDRO HUAMELULA,1,0,1,0,0,0,0,0,0,0,0,0,1,0,1,0
1319,20,OAXACA,20308,SAN PEDRO HUILOTEPEC,0,0,0,0,0,0,0,0,0,0,0,0,0,0,0,0
1320,20,OAXACA,20309,SAN PEDRO IXCATLAN,0,0,0,0,0,0,0,0,0,0,0,0,0,0,0,0
1321,20,OAXACA,20310,SAN PEDRO IXTLAHUACA,0,0,0,0,0,0,0,0,0,0,0,0,0,0,0,0
1322,20,OAXACA,20311,SAN PEDRO JALTEPETONGO,0,0,0,0,0,0,0,0,0,0,0,0,0,0,0,0
1323,20,OAXACA,20312,SAN PEDRO JICAYAN,0,0,0,0,0,0,0,0,0,0,0,0,0,0,0,0
1324,20,OAXACA,20313,SAN PEDRO JOCOTIPAC,0,0,0,0,0,0,0,0,0,0,0,0,0,0,0,0
1325,20,OAXACA,20314,SAN PEDRO JUCHATENGO,0,0,0,0,0,0,0,0,0,0,0,0,0,0,0,0
1326,20,OAXACA,20315,SAN PEDRO MARTIR,2,2,0,0,0,0,0,0,0,0,0,0,2,2,0,0
1327,20,OAXACA,20316,SAN PEDRO MARTIR QUIECHAPA,0,0,0,0,0,0,0,0,0,0,0,0,0,0,0,0
1328,20,OAXACA,20317,SAN PEDRO MARTIR YUCUXACO,0,0,0,0,0,0,0,0,0,0,0,0,0,0,0,0
1329,20,OAXACA,20318,SAN PEDRO MIXTEPEC,6,0,6,0,0,0,0,0,0,0,0,0,6,0,6,0
1330,20,OAXACA,20319,SAN PEDRO MIXTEPEC,1,0,1,0,0,0,0,0,0,0,0,0,1,0,1,0
1331,20,OAXACA,20320,SAN PEDRO MOLINOS,0,0,0,0,0,0,0,0,0,0,0,0,0,0,0,0
1332,20,OAXACA,20321,SAN PEDRO NOPALA,0,0,0,0,0,0,0,0,0,0,0,0,0,0,0,0
1333,20,OAXACA,20322,SAN PEDRO OCOPETATILLO,0,0,0,0,0,0,0,0,0,0,0,0,0,0,0,0
1334,20,OAXACA,20323,SAN PEDRO OCOTEPEC,0,0,0,0,0,0,0,0,0,0,0,0,0,0,0,0
1335,20,OAXACA,20324,SAN PEDRO POCHUTLA,2,0,2,0,0,0,0,0,0,0,0,0,2,0,2,0
1336,20,OAXACA,20325,SAN PEDRO QUIATONI,0,0,0,0,0,0,0,0,0,0,0,0,0,0,0,0
1337,20,OAXACA,20326,SAN PEDRO SOCHIAPAM,0,0,0,0,0,0,0,0,0,0,0,0,0,0,0,0
1338,20,OAXACA,20327,SAN PEDRO TAPANATEPEC,13,10,3,0,0,0,0,0,0,0,0,0,13,10,3,0
1339,20,OAXACA,20328,SAN PEDRO TAVICHE,0,0,0,0,0,0,0,0,0,0,0,0,0,0,0,0
1340,20,OAXACA,20329,SAN PEDRO TEOZACOALCO,0,0,0,0,0,0,0,0,0,0,0,0,0,0,0,0
1341,20,OAXACA,20330,SAN PEDRO TEUTILA,0,0,0,0,0,0,0,0,0,0,0,0,0,0,0,0
1342,20,OAXACA,20331,SAN PEDRO TIDAA,0,0,0,0,0,0,0,0,0,0,0,0,0,0,0,0
1343,20,OAXACA,20332,SAN PEDRO TOPILTEPEC,0,0,0,0,0,0,0,0,0,0,0,0,0,0,0,0
1344,20,OAXACA,20333,SAN PEDRO TOTOLAPAM,2,1,1,0,0,0,0,0,0,0,0,0,2,1,1,0
1345,20,OAXACA,20334,VILLA DE TUTUTEPEC,5,0,5,0,0,0,0,0,0,0,0,0,5,0,5,0
1346,20,OAXACA,20335,SAN PEDRO YANERI,0,0,0,0,0,0,0,0,0,0,0,0,0,0,0,0
1347,20,OAXACA,20336,SAN PEDRO YOLOX,0,0,0,0,0,0,0,0,0,0,0,0,0,0,0,0
1348,20,OAXACA,20337,SAN PEDRO Y SAN PABLO AYUTLA,0,0,0,0,0,0,0,0,0,0,0,0,0,0,0,0
1349,20,OAXACA,20338,VILLA DE ETLA,3,1,2,0,0,0,0,0,0,0,0,0,3,1,2,0
1350,20,OAXACA,20339,SAN PEDRO Y SAN PABLO TEPOSCOLULA,0,0,0,0,0,0,0,0,0,0,0,0,0,0,0,0
1351,20,OAXACA,20340,SAN PEDRO Y SAN PABLO TEQUIXTEPEC,1,0,1,0,0,0,0,0,0,0,0,0,1,0,1,0
1352,20,OAXACA,20341,SAN PEDRO YUCUNAMA,0,0,0,0,0,0,0,0,0,0,0,0,0,0,0,0
1353,20,OAXACA,20342,SAN RAYMUNDO JALPAN,0,0,0,0,0,0,0,0,0,0,0,0,0,0,0,0
1354,20,OAXACA,20343,SAN SEBASTIAN ABASOLO,0,0,0,0,0,0,0,0,0,0,0,0,0,0,0,0
1355,20,OAXACA,20344,SAN SEBASTIAN COATLAN,0,0,0,0,0,0,0,0,0,0,0,0,0,0,0,0
1356,20,OAXACA,20345,SAN SEBASTIAN IXCAPA,0,0,0,0,0,0,0,0,0,0,0,0,0,0,0,0
1357,20,OAXACA,20346,SAN SEBASTIAN NICANANDUTA,0,0,0,0,0,0,0,0,0,0,0,0,0,0,0,0
1358,20,OAXACA,20347,SAN SEBASTIAN RIO HONDO,0,0,0,0,0,0,0,0,0,0,0,0,0,0,0,0
1359,20,OAXACA,20348,SAN SEBASTIAN TECOMAXTLAHUACA,0,0,0,0,0,0,0,0,0,0,0,0,0,0,0,0
1360,20,OAXACA,20349,SAN SEBASTIAN TEITIPAC,0,0,0,0,0,0,0,0,0,0,0,0,0,0,0,0
1361,20,OAXACA,20350,SAN SEBASTIAN TUTLA,0,0,0,0,0,0,0,0,0,0,0,0,0,0,0,0
1362,20,OAXACA,20351,SAN SIMON ALMOLONGAS,0,0,0,0,0,0,0,0,0,0,0,0,0,0,0,0
1363,20,OAXACA,20352,SAN SIMON ZAHUATLAN,0,0,0,0,0,0,0,0,0,0,0,0,0,0,0,0
1364,20,OAXACA,20353,SANTA ANA,0,0,0,0,0,0,0,0,0,0,0,0,0,0,0,0
1365,20,OAXACA,20354,SANTA ANA ATEIXTLAHUACA,0,0,0,0,0,0,0,0,0,0,0,0,0,0,0,0
1366,20,OAXACA,20355,SANTA ANA CUAUHTEMOC,0,0,0,0,0,0,0,0,0,0,0,0,0,0,0,0
1367,20,OAXACA,20356,SANTA ANA DEL VALLE,0,0,0,0,0,0,0,0,0,0,0,0,0,0,0,0
1368,20,OAXACA,20357,SANTA ANA TAVELA,0,0,0,0,0,0,0,0,0,0,0,0,0,0,0,0
1369,20,OAXACA,20358,SANTA ANA TLAPACOYAN,0,0,0,0,0,0,0,0,0,0,0,0,0,0,0,0
1370,20,OAXACA,20359,SANTA ANA YARENI,0,0,0,0,0,0,0,0,0,0,0,0,0,0,0,0
1371,20,OAXACA,20360,SANTA ANA ZEGACHE,0,0,0,0,0,0,0,0,0,0,0,0,0,0,0,0
1372,20,OAXACA,20361,SANTA CATALINA QUIERI,0,0,0,0,0,0,0,0,0,0,0,0,0,0,0,0
1373,20,OAXACA,20362,SANTA CATARINA CUIXTLA,0,0,0,0,0,0,0,0,0,0,0,0,0,0,0,0
1374,20,OAXACA,20363,SANTA CATARINA IXTEPEJI,0,0,0,0,0,0,0,0,0,0,0,0,0,0,0,0
1375,20,OAXACA,20364,SANTA CATARINA JUQUILA,0,0,0,0,0,0,0,0,0,0,0,0,0,0,0,0
1376,20,OAXACA,20365,SANTA CATARINA LACHATAO,0,0,0,0,0,0,0,0,0,0,0,0,0,0,0,0
1377,20,OAXACA,20366,SANTA CATARINA LOXICHA,0,0,0,0,0,0,0,0,0,0,0,0,0,0,0,0
1378,20,OAXACA,20367,SANTA CATARINA MECHOACAN,0,0,0,0,0,0,0,0,0,0,0,0,0,0,0,0
1379,20,OAXACA,20368,SANTA CATARINA MINAS,0,0,0,0,0,0,0,0,0,0,0,0,0,0,0,0
1380,20,OAXACA,20369,SANTA CATARINA QUIANE,0,0,0,0,0,0,0,0,0,0,0,0,0,0,0,0
1381,20,OAXACA,20370,SANTA CATARINA TAYATA,0,0,0,0,0,0,0,0,0,0,0,0,0,0,0,0
1382,20,OAXACA,20371,SANTA CATARINA TICUA,0,0,0,0,0,0,0,0,0,0,0,0,0,0,0,0
1383,20,OAXACA,20372,SANTA CATARINA YOSONOTU,0,0,0,0,0,0,0,0,0,0,0,0,0,0,0,0
1384,20,OAXACA,20373,SANTA CATARINA ZAPOQUILA,0,0,0,0,0,0,0,0,0,0,0,0,0,0,0,0
1385,20,OAXACA,20374,SANTA CRUZ ACATEPEC,0,0,0,0,0,0,0,0,0,0,0,0,0,0,0,0
1386,20,OAXACA,20375,SANTA CRUZ AMILPAS,0,0,0,0,0,0,0,0,0,0,0,0,0,0,0,0
1387,20,OAXACA,20376,SANTA CRUZ DE BRAVO,0,0,0,0,0,0,0,0,0,0,0,0,0,0,0,0
1388,20,OAXACA,20377,SANTA CRUZ ITUNDUJIA,0,0,0,0,0,0,0,0,0,0,0,0,0,0,0,0
1389,20,OAXACA,20378,SANTA CRUZ MIXTEPEC,0,0,0,0,0,0,0,0,0,0,0,0,0,0,0,0
1390,20,OAXACA,20379,SANTA CRUZ NUNDACO,0,0,0,0,0,0,0,0,0,0,0,0,0,0,0,0
1391,20,OAXACA,20380,SANTA CRUZ PAPALUTLA,0,0,0,0,0,0,0,0,0,0,0,0,0,0,0,0
1392,20,OAXACA,20381,SANTA CRUZ TACACHE DE MINA,0,0,0,0,0,0,0,0,0,0,0,0,0,0,0,0
1393,20,OAXACA,20382,SANTA CRUZ TACAHUA,0,0,0,0,0,0,0,0,0,0,0,0,0,0,0,0
1394,20,OAXACA,20383,SANTA CRUZ TAYATA,0,0,0,0,0,0,0,0,0,0,0,0,0,0,0,0
1395,20,OAXACA,20384,SANTA CRUZ XITLA,0,0,0,0,0,0,0,0,0,0,0,0,0,0,0,0
1396,20,OAXACA,20385,SANTA CRUZ XOXOCOTLAN,0,0,0,0,0,0,0,0,0,0,0,0,0,0,0,0
1397,20,OAXACA,20386,SANTA CRUZ ZENZONTEPEC,0,0,0,0,0,0,0,0,0,0,0,0,0,0,0,0
1398,20,OAXACA,20387,SANTA GERTRUDIS,0,0,0,0,0,0,0,0,0,0,0,0,0,0,0,0
1399,20,OAXACA,20388,SANTA INES DEL MONTE,0,0,0,0,0,0,0,0,0,0,0,0,0,0,0,0
1400,20,OAXACA,20389,SANTA INES YATZECHE,0,0,0,0,0,0,0,0,0,0,0,0,0,0,0,0
1401,20,OAXACA,20390,SANTA LUCIA DEL CAMINO,2,1,1,0,0,0,0,0,0,0,0,0,2,1,1,0
1402,20,OAXACA,20391,SANTA LUCIA MIAHUATLAN,0,0,0,0,0,0,0,0,0,0,0,0,0,0,0,0
1403,20,OAXACA,20392,SANTA LUCIA MONTEVERDE,0,0,0,0,0,0,0,0,0,0,0,0,0,0,0,0
1404,20,OAXACA,20393,SANTA LUCIA OCOTLAN,0,0,0,0,0,0,0,0,0,0,0,0,0,0,0,0
1405,20,OAXACA,20394,SANTA MARIA ALOTEPEC,0,0,0,0,0,0,0,0,0,0,0,0,0,0,0,0
1406,20,OAXACA,20395,SANTA MARIA APAZCO,0,0,0,0,0,0,0,0,0,0,0,0,0,0,0,0
1407,20,OAXACA,20396,SANTA MARIA LA ASUNCION,0,0,0,0,0,0,0,0,0,0,0,0,0,0,0,0
1408,20,OAXACA,20397,HEROICA CIUDAD DE TLAXIACO,0,0,0,0,0,0,0,0,0,0,0,0,0,0,0,0
1409,20,OAXACA,20398,AYOQUEZCO DE ALDAMA,0,0,0,0,0,0,0,0,0,0,0,0,0,0,0,0
1410,20,OAXACA,20399,SANTA MARIA ATZOMPA,0,0,0,0,0,0,0,0,0,0,0,0,0,0,0,0
1411,20,OAXACA,20400,SANTA MARIA CAMOTLAN,0,0,0,0,0,0,0,0,0,0,0,0,0,0,0,0
1412,20,OAXACA,20401,SANTA MARIA COLOTEPEC,8,4,4,0,0,0,0,0,0,0,0,0,8,4,4,0
1413,20,OAXACA,20402,SANTA MARIA CORTIJO,0,0,0,0,0,0,0,0,0,0,0,0,0,0,0,0
1414,20,OAXACA,20403,SANTA MARIA COYOTEPEC,0,0,0,0,0,0,0,0,0,0,0,0,0,0,0,0
1415,20,OAXACA,20404,SANTA MARIA CHACHOAPAM,0,0,0,0,0,0,0,0,0,0,0,0,0,0,0,0
1416,20,OAXACA,20405,VILLA DE CHILAPA DE DIAZ,0,0,0,0,0,0,0,0,0,0,0,0,0,0,0,0
1417,20,OAXACA,20406,SANTA MARIA CHILCHOTLA,0,0,0,0,0,0,0,0,0,0,0,0,0,0,0,0
1418,20,OAXACA,20407,SANTA MARIA CHIMALAPA,0,0,0,0,0,0,0,0,0,0,0,0,0,0,0,0
1419,20,OAXACA,20408,SANTA MARIA DEL ROSARIO,0,0,0,0,0,0,0,0,0,0,0,0,0,0,0,0
1420,20,OAXACA,20409,SANTA MARIA DEL TULE,0,0,0,0,0,0,0,0,0,0,0,0,0,0,0,0
1421,20,OAXACA,20410,SANTA MARIA ECATEPEC,0,0,0,0,0,0,0,0,0,0,0,0,0,0,0,0
1422,20,OAXACA,20411,SANTA MARIA GUELACE,0,0,0,0,0,0,0,0,0,0,0,0,0,0,0,0
1423,20,OAXACA,20412,SANTA MARIA GUIENAGATI,0,0,0,0,0,0,0,0,0,0,0,0,0,0,0,0
1424,20,OAXACA,20413,SANTA MARIA HUATULCO,5,0,5,0,0,0,0,0,0,0,0,0,5,0,5,0
1425,20,OAXACA,20414,SANTA MARIA HUAZOLOTITLAN,0,0,0,0,0,0,0,0,0,0,0,0,0,0,0,0
1426,20,OAXACA,20415,SANTA MARIA IPALAPA,0,0,0,0,0,0,0,0,0,0,0,0,0,0,0,0
1427,20,OAXACA,20416,SANTA MARIA IXCATLAN,0,0,0,0,0,0,0,0,0,0,0,0,0,0,0,0
1428,20,OAXACA,20417,SANTA MARIA JACATEPEC,0,0,0,0,0,0,0,0,0,0,0,0,0,0,0,0
1429,20,OAXACA,20418,SANTA MARIA JALAPA DEL MARQUES,5,4,1,0,0,0,0,0,0,0,0,0,5,4,1,0
1430,20,OAXACA,20419,SANTA MARIA JALTIANGUIS,0,0,0,0,0,0,0,0,0,0,0,0,0,0,0,0
1431,20,OAXACA,20420,SANTA MARIA LACHIXIO,0,0,0,0,0,0,0,0,0,0,0,0,0,0,0,0
1432,20,OAXACA,20421,SANTA MARIA MIXTEQUILLA,0,0,0,0,0,0,0,0,0,0,0,0,0,0,0,0
1433,20,OAXACA,20422,SANTA MARIA NATIVITAS,0,0,0,0,0,0,0,0,0,0,0,0,0,0,0,0
1434,20,OAXACA,20423,SANTA MARIA NDUAYACO,0,0,0,0,0,0,0,0,0,0,0,0,0,0,0,0
1435,20,OAXACA,20424,SANTA MARIA OZOLOTEPEC,0,0,0,0,0,0,0,0,0,0,0,0,0,0,0,0
1436,20,OAXACA,20425,SANTA MARIA PAPALO,0,0,0,0,0,0,0,0,0,0,0,0,0,0,0,0
1437,20,OAXACA,20426,SANTA MARIA PEÑOLES,0,0,0,0,0,0,0,0,0,0,0,0,0,0,0,0
1438,20,OAXACA,20427,SANTA MARIA PETAPA,1,0,1,0,0,0,0,0,0,0,0,0,1,0,1,0
1439,20,OAXACA,20428,SANTA MARIA QUIEGOLANI,0,0,0,0,0,0,0,0,0,0,0,0,0,0,0,0
1440,20,OAXACA,20429,SANTA MARIA SOLA,0,0,0,0,0,0,0,0,0,0,0,0,0,0,0,0
1441,20,OAXACA,20430,SANTA MARIA TATALTEPEC,0,0,0,0,0,0,0,0,0,0,0,0,0,0,0,0
1442,20,OAXACA,20431,SANTA MARIA TECOMAVACA,0,0,0,0,0,0,0,0,0,0,0,0,0,0,0,0
1443,20,OAXACA,20432,SANTA MARIA TEMAXCALAPA,0,0,0,0,0,0,0,0,0,0,0,0,0,0,0,0
1444,20,OAXACA,20433,SANTA MARIA TEMAXCALTEPEC,0,0,0,0,0,0,0,0,0,0,0,0,0,0,0,0
1445,20,OAXACA,20434,SANTA MARIA TEOPOXCO,0,0,0,0,0,0,0,0,0,0,0,0,0,0,0,0
1446,20,OAXACA,20435,SANTA MARIA TEPANTLALI,0,0,0,0,0,0,0,0,0,0,0,0,0,0,0,0
1447,20,OAXACA,20436,SANTA MARIA TEXCATITLAN,0,0,0,0,0,0,0,0,0,0,0,0,0,0,0,0
1448,20,OAXACA,20437,SANTA MARIA TLAHUITOLTEPEC,0,0,0,0,0,0,0,0,0,0,0,0,0,0,0,0
1449,20,OAXACA,20438,SANTA MARIA TLALIXTAC,0,0,0,0,0,0,0,0,0,0,0,0,0,0,0,0
1450,20,OAXACA,20439,SANTA MARIA TONAMECA,0,0,0,0,0,0,0,0,0,0,0,0,0,0,0,0
1451,20,OAXACA,20440,SANTA MARIA TOTOLAPILLA,0,0,0,0,0,0,0,0,0,0,0,0,0,0,0,0
1452,20,OAXACA,20441,SANTA MARIA XADANI,0,0,0,0,0,0,0,0,0,0,0,0,0,0,0,0
1453,20,OAXACA,20442,SANTA MARIA YALINA,0,0,0,0,0,0,0,0,0,0,0,0,0,0,0,0
1454,20,OAXACA,20443,SANTA MARIA YAVESIA,0,0,0,0,0,0,0,0,0,0,0,0,0,0,0,0
1455,20,OAXACA,20444,SANTA MARIA YOLOTEPEC,0,0,0,0,0,0,0,0,0,0,0,0,0,0,0,0
1456,20,OAXACA,20445,SANTA MARIA YOSOYUA,0,0,0,0,0,0,0,0,0,0,0,0,0,0,0,0
1457,20,OAXACA,20446,SANTA MARIA YUCUHITI,0,0,0,0,0,0,0,0,0,0,0,0,0,0,0,0
1458,20,OAXACA,20447,SANTA MARIA ZACATEPEC,0,0,0,0,0,0,0,0,0,0,0,0,0,0,0,0
1459,20,OAXACA,20448,SANTA MARIA ZANIZA,0,0,0,0,0,0,0,0,0,0,0,0,0,0,0,0
1460,20,OAXACA,20449,SANTA MARIA ZOQUITLAN,0,0,0,0,0,0,0,0,0,0,0,0,0,0,0,0
1461,20,OAXACA,20450,SANTIAGO AMOLTEPEC,0,0,0,0,0,0,0,0,0,0,0,0,0,0,0,0
1462,20,OAXACA,20451,SANTIAGO APOALA,0,0,0,0,0,0,0,0,0,0,0,0,0,0,0,0
1463,20,OAXACA,20452,SANTIAGO APOSTOL,0,0,0,0,0,0,0,0,0,0,0,0,0,0,0,0
1464,20,OAXACA,20453,SANTIAGO ASTATA,0,0,0,0,0,0,0,0,0,0,0,0,0,0,0,0
1465,20,OAXACA,20454,SANTIAGO ATITLAN,0,0,0,0,0,0,0,0,0,0,0,0,0,0,0,0
1466,20,OAXACA,20455,SANTIAGO AYUQUILILLA,0,0,0,0,0,0,0,0,0,0,0,0,0,0,0,0
1467,20,OAXACA,20456,SANTIAGO CACALOXTEPEC,0,0,0,0,0,0,0,0,0,0,0,0,0,0,0,0
1468,20,OAXACA,20457,SANTIAGO CAMOTLAN,0,0,0,0,0,0,0,0,0,0,0,0,0,0,0,0
1469,20,OAXACA,20458,SANTIAGO COMALTEPEC,0,0,0,0,0,0,0,0,0,0,0,0,0,0,0,0
1470,20,OAXACA,20459,VILLA DE SANTIAGO CHAZUMBA,0,0,0,0,0,0,0,0,0,0,0,0,0,0,0,0
1471,20,OAXACA,20460,SANTIAGO CHOAPAM,0,0,0,0,0,0,0,0,0,0,0,0,0,0,0,0
1472,20,OAXACA,20461,SANTIAGO DEL RIO,0,0,0,0,0,0,0,0,0,0,0,0,0,0,0,0
1473,20,OAXACA,20462,SANTIAGO HUAJOLOTITLAN,0,0,0,0,0,0,0,0,0,0,0,0,0,0,0,0
1474,20,OAXACA,20463,SANTIAGO HUAUCLILLA,0,0,0,0,0,0,0,0,0,0,0,0,0,0,0,0
1475,20,OAXACA,20464,SANTIAGO IHUITLAN PLUMAS,0,0,0,0,0,0,0,0,0,0,0,0,0,0,0,0
1476,20,OAXACA,20465,SANTIAGO IXCUINTEPEC,0,0,0,0,0,0,0,0,0,0,0,0,0,0,0,0
1477,20,OAXACA,20466,SANTIAGO IXTAYUTLA,0,0,0,0,0,0,0,0,0,0,0,0,0,0,0,0
1478,20,OAXACA,20467,SANTIAGO JAMILTEPEC,1,1,0,0,0,0,0,0,0,0,0,0,1,1,0,0
1479,20,OAXACA,20468,SANTIAGO JOCOTEPEC,0,0,0,0,0,0,0,0,0,0,0,0,0,0,0,0
1480,20,OAXACA,20469,SANTIAGO JUXTLAHUACA,0,0,0,0,0,0,0,0,0,0,0,0,0,0,0,0
1481,20,OAXACA,20470,SANTIAGO LACHIGUIRI,0,0,0,0,0,0,0,0,0,0,0,0,0,0,0,0
1482,20,OAXACA,20471,SANTIAGO LALOPA,0,0,0,0,0,0,0,0,0,0,0,0,0,0,0,0
1483,20,OAXACA,20472,SANTIAGO LAOLLAGA,0,0,0,0,0,0,0,0,0,0,0,0,0,0,0,0
1484,20,OAXACA,20473,SANTIAGO LAXOPA,0,0,0,0,0,0,0,0,0,0,0,0,0,0,0,0
1485,20,OAXACA,20474,SANTIAGO LLANO GRANDE,0,0,0,0,0,0,0,0,0,0,0,0,0,0,0,0
1486,20,OAXACA,20475,SANTIAGO MATATLAN,5,0,5,0,0,0,0,0,0,0,0,0,5,0,5,0
1487,20,OAXACA,20476,SANTIAGO MILTEPEC,2,2,0,0,0,0,0,0,0,0,0,0,2,2,0,0
1488,20,OAXACA,20477,SANTIAGO MINAS,0,0,0,0,0,0,0,0,0,0,0,0,0,0,0,0
1489,20,OAXACA,20478,SANTIAGO NACALTEPEC,0,0,0,0,0,0,0,0,0,0,0,0,0,0,0,0
1490,20,OAXACA,20479,SANTIAGO NEJAPILLA,0,0,0,0,0,0,0,0,0,0,0,0,0,0,0,0
1491,20,OAXACA,20480,SANTIAGO NUNDICHE,0,0,0,0,0,0,0,0,0,0,0,0,0,0,0,0
1492,20,OAXACA,20481,SANTIAGO NUYOO,0,0,0,0,0,0,0,0,0,0,0,0,0,0,0,0
1493,20,OAXACA,20482,SANTIAGO PINOTEPA NACIONAL,18,2,16,0,0,0,0,0,0,0,0,0,18,2,16,0
1494,20,OAXACA,20483,SANTIAGO SUCHILQUITONGO,2,0,2,0,0,0,0,0,0,0,0,0,2,0,2,0
1495,20,OAXACA,20484,SANTIAGO TAMAZOLA,0,0,0,0,0,0,0,0,0,0,0,0,0,0,0,0
1496,20,OAXACA,20485,SANTIAGO TAPEXTLA,0,0,0,0,0,0,0,0,0,0,0,0,0,0,0,0
1497,20,OAXACA,20486,VILLA TEJUPAM DE LA UNION,0,0,0,0,0,0,0,0,0,0,0,0,0,0,0,0
1498,20,OAXACA,20487,SANTIAGO TENANGO,1,0,1,0,0,0,0,0,0,0,0,0,1,0,1,0
1499,20,OAXACA,20488,SANTIAGO TEPETLAPA,0,0,0,0,0,0,0,0,0,0,0,0,0,0,0,0
1500,20,OAXACA,20489,SANTIAGO TETEPEC,0,0,0,0,0,0,0,0,0,0,0,0,0,0,0,0
1501,20,OAXACA,20490,SANTIAGO TEXCALCINGO,0,0,0,0,0,0,0,0,0,0,0,0,0,0,0,0
1502,20,OAXACA,20491,SANTIAGO TEXTITLAN,0,0,0,0,0,0,0,0,0,0,0,0,0,0,0,0
1503,20,OAXACA,20492,SANTIAGO TILANTONGO,0,0,0,0,0,0,0,0,0,0,0,0,0,0,0,0
1504,20,OAXACA,20493,SANTIAGO TILLO,0,0,0,0,0,0,0,0,0,0,0,0,0,0,0,0
1505,20,OAXACA,20494,SANTIAGO TLAZOYALTEPEC,0,0,0,0,0,0,0,0,0,0,0,0,0,0,0,0
1506,20,OAXACA,20495,SANTIAGO XANICA,0,0,0,0,0,0,0,0,0,0,0,0,0,0,0,0
1507,20,OAXACA,20496,SANTIAGO XIACUI,0,0,0,0,0,0,0,0,0,0,0,0,0,0,0,0
1508,20,OAXACA,20497,SANTIAGO YAITEPEC,0,0,0,0,0,0,0,0,0,0,0,0,0,0,0,0
1509,20,OAXACA,20498,SANTIAGO YAVEO,0,0,0,0,0,0,0,0,0,0,0,0,0,0,0,0
1510,20,OAXACA,20499,SANTIAGO YOLOMECATL,0,0,0,0,0,0,0,0,0,0,0,0,0,0,0,0
1511,20,OAXACA,20500,SANTIAGO YOSONDUA,0,0,0,0,0,0,0,0,0,0,0,0,0,0,0,0
1512,20,OAXACA,20501,SANTIAGO YUCUYACHI,0,0,0,0,0,0,0,0,0,0,0,0,0,0,0,0
1513,20,OAXACA,20502,SANTIAGO ZACATEPEC,0,0,0,0,0,0,0,0,0,0,0,0,0,0,0,0
1514,20,OAXACA,20503,SANTIAGO ZOOCHILA,0,0,0,0,0,0,0,0,0,0,0,0,0,0,0,0
1515,20,OAXACA,20504,NUEVO ZOQUIAPAM,0,0,0,0,0,0,0,0,0,0,0,0,0,0,0,0
1516,20,OAXACA,20505,SANTO DOMINGO INGENIO,0,0,0,0,0,0,0,0,0,0,0,0,0,0,0,0
1517,20,OAXACA,20506,SANTO DOMINGO ALBARRADAS,0,0,0,0,0,0,0,0,0,0,0,0,0,0,0,0
1518,20,OAXACA,20507,SANTO DOMINGO ARMENTA,0,0,0,0,0,0,0,0,0,0,0,0,0,0,0,0
1519,20,OAXACA,20508,SANTO DOMINGO CHIHUITAN,0,0,0,0,0,0,0,0,0,0,0,0,0,0,0,0
1520,20,OAXACA,20509,SANTO DOMINGO DE MORELOS,0,0,0,0,0,0,0,0,0,0,0,0,0,0,0,0
1521,20,OAXACA,20510,SANTO DOMINGO IXCATLAN,0,0,0,0,0,0,0,0,0,0,0,0,0,0,0,0
1522,20,OAXACA,20511,SANTO DOMINGO NUXAA,0,0,0,0,0,0,0,0,0,0,0,0,0,0,0,0
1523,20,OAXACA,20512,SANTO DOMINGO OZOLOTEPEC,0,0,0,0,0,0,0,0,0,0,0,0,0,0,0,0
1524,20,OAXACA,20513,SANTO DOMINGO PETAPA,0,0,0,0,0,0,0,0,0,0,0,0,0,0,0,0
1525,20,OAXACA,20514,SANTO DOMINGO ROAYAGA,0,0,0,0,0,0,0,0,0,0,0,0,0,0,0,0
1526,20,OAXACA,20515,SANTO DOMINGO TEHUANTEPEC,8,8,0,0,0,0,0,0,0,0,0,0,8,8,0,0
1527,20,OAXACA,20516,SANTO DOMINGO TEOJOMULCO,0,0,0,0,0,0,0,0,0,0,0,0,0,0,0,0
1528,20,OAXACA,20517,SANTO DOMINGO TEPUXTEPEC,0,0,0,0,0,0,0,0,0,0,0,0,0,0,0,0
1529,20,OAXACA,20518,SANTO DOMINGO TLATAYAPAM,0,0,0,0,0,0,0,0,0,0,0,0,0,0,0,0
1530,20,OAXACA,20519,SANTO DOMINGO TOMALTEPEC,14,0,14,0,0,0,0,0,0,0,0,0,14,0,14,0
1531,20,OAXACA,20520,SANTO DOMINGO TONALA,0,0,0,0,0,0,0,0,0,0,0,0,0,0,0,0
1532,20,OAXACA,20521,SANTO DOMINGO TONALTEPEC,0,0,0,0,0,0,0,0,0,0,0,0,0,0,0,0
1533,20,OAXACA,20522,SANTO DOMINGO XAGACIA,0,0,0,0,0,0,0,0,0,0,0,0,0,0,0,0
1534,20,OAXACA,20523,SANTO DOMINGO YANHUITLAN,0,0,0,0,0,0,0,0,0,0,0,0,0,0,0,0
1535,20,OAXACA,20524,SANTO DOMINGO YODOHINO,0,0,0,0,0,0,0,0,0,0,0,0,0,0,0,0
1536,20,OAXACA,20525,SANTO DOMINGO ZANATEPEC,4,1,3,0,0,0,0,0,0,0,0,0,4,1,3,0
1537,20,OAXACA,20526,SANTOS REYES NOPALA,0,0,0,0,0,0,0,0,0,0,0,0,0,0,0,0
1538,20,OAXACA,20527,SANTOS REYES PAPALO,0,0,0,0,0,0,0,0,0,0,0,0,0,0,0,0
1539,20,OAXACA,20528,SANTOS REYES TEPEJILLO,0,0,0,0,0,0,0,0,0,0,0,0,0,0,0,0
1540,20,OAXACA,20529,SANTOS REYES YUCUNA,0,0,0,0,0,0,0,0,0,0,0,0,0,0,0,0
1541,20,OAXACA,20530,SANTO TOMAS JALIEZA,0,0,0,0,0,0,0,0,0,0,0,0,0,0,0,0
1542,20,OAXACA,20531,SANTO TOMAS MAZALTEPEC,0,0,0,0,0,0,0,0,0,0,0,0,0,0,0,0
1543,20,OAXACA,20532,SANTO TOMAS OCOTEPEC,0,0,0,0,0,0,0,0,0,0,0,0,0,0,0,0
1544,20,OAXACA,20533,SANTO TOMAS TAMAZULAPAN,0,0,0,0,0,0,0,0,0,0,0,0,0,0,0,0
1545,20,OAXACA,20534,SAN VICENTE COATLAN,0,0,0,0,0,0,0,0,0,0,0,0,0,0,0,0
1546,20,OAXACA,20535,SAN VICENTE LACHIXIO,0,0,0,0,0,0,0,0,0,0,0,0,0,0,0,0
1547,20,OAXACA,20536,SAN VICENTE NUÑU,0,0,0,0,0,0,0,0,0,0,0,0,0,0,0,0
1548,20,OAXACA,20537,SILACAYOAPAM,0,0,0,0,0,0,0,0,0,0,0,0,0,0,0,0
1549,20,OAXACA,20538,SITIO DE XITLAPEHUA,0,0,0,0,0,0,0,0,0,0,0,0,0,0,0,0
1550,20,OAXACA,20539,SOLEDAD ETLA,0,0,0,0,0,0,0,0,0,0,0,0,0,0,0,0
1551,20,OAXACA,20540,VILLA DE TAMAZULAPAM DEL PROGRESO,0,0,0,0,0,0,0,0,0,0,0,0,0,0,0,0
1552,20,OAXACA,20541,TANETZE DE ZARAGOZA,0,0,0,0,0,0,0,0,0,0,0,0,0,0,0,0
1553,20,OAXACA,20542,TANICHE,0,0,0,0,0,0,0,0,0,0,0,0,0,0,0,0
1554,20,OAXACA,20543,TATALTEPEC DE VALDES,0,0,0,0,0,0,0,0,0,0,0,0,0,0,0,0
1555,20,OAXACA,20544,TEOCOCUILCO DE MARCOS PEREZ,0,0,0,0,0,0,0,0,0,0,0,0,0,0,0,0
1556,20,OAXACA,20545,TEOTITLAN DE FLORES MAGON,0,0,0,0,0,0,0,0,0,0,0,0,0,0,0,0
1557,20,OAXACA,20546,TEOTITLAN DEL VALLE,0,0,0,0,0,0,0,0,0,0,0,0,0,0,0,0
1558,20,OAXACA,20547,TEOTONGO,0,0,0,0,0,0,0,0,0,0,0,0,0,0,0,0
1559,20,OAXACA,20548,TEPELMEME VILLA DE MORELOS,2,1,1,0,0,0,0,0,0,0,0,0,2,1,1,0
1560,20,OAXACA,20549,HEROICA VILLA TEZOATLAN DE SEGURA Y LUNA CUNA DE LA INDEPENDENCIA DE OAXACA,0,0,0,0,0,0,0,0,0,0,0,0,0,0,0,0
1561,20,OAXACA,20550,SAN JERONIMO TLACOCHAHUAYA,0,0,0,0,0,0,0,0,0,0,0,0,0,0,0,0
1562,20,OAXACA,20551,TLACOLULA DE MATAMOROS,6,4,2,0,0,0,0,0,0,0,0,0,6,4,2,0
1563,20,OAXACA,20552,TLACOTEPEC PLUMAS,0,0,0,0,0,0,0,0,0,0,0,0,0,0,0,0
1564,20,OAXACA,20553,TLALIXTAC DE CABRERA,0,0,0,0,0,0,0,0,0,0,0,0,0,0,0,0
1565,20,OAXACA,20554,TOTONTEPEC VILLA DE MORELOS,0,0,0,0,0,0,0,0,0,0,0,0,0,0,0,0
1566,20,OAXACA,20555,TRINIDAD ZAACHILA,0,0,0,0,0,0,0,0,0,0,0,0,0,0,0,0
1567,20,OAXACA,20556,LA TRINIDAD VISTA HERMOSA,0,0,0,0,0,0,0,0,0,0,0,0,0,0,0,0
1568,20,OAXACA,20557,UNION HIDALGO,0,0,0,0,0,0,0,0,0,0,0,0,0,0,0,0
1569,20,OAXACA,20558,VALERIO TRUJANO,0,0,0,0,0,0,0,0,0,0,0,0,0,0,0,0
1570,20,OAXACA,20559,SAN JUAN BAUTISTA VALLE NACIONAL,0,0,0,0,0,0,0,0,0,0,0,0,0,0,0,0
1571,20,OAXACA,20560,VILLA DIAZ ORDAZ,0,0,0,0,0,0,0,0,0,0,0,0,0,0,0,0
1572,20,OAXACA,20561,YAXE,0,0,0,0,0,0,0,0,0,0,0,0,0,0,0,0
1573,20,OAXACA,20562,MAGDALENA YODOCONO DE PORFIRIO DIAZ,0,0,0,0,0,0,0,0,0,0,0,0,0,0,0,0
1574,20,OAXACA,20563,YOGANA,0,0,0,0,0,0,0,0,0,0,0,0,0,0,0,0
1575,20,OAXACA,20564,YUTANDUCHI DE GUERRERO,0,0,0,0,0,0,0,0,0,0,0,0,0,0,0,0
1576,20,OAXACA,20565,VILLA DE ZAACHILA,2,2,0,0,0,0,0,0,0,0,0,0,2,2,0,0
1577,20,OAXACA,20566,SAN MATEO YUCUTINDOO,0,0,0,0,0,0,0,0,0,0,0,0,0,0,0,0
1578,20,OAXACA,20567,ZAPOTITLAN LAGUNAS,0,0,0,0,0,0,0,0,0,0,0,0,0,0,0,0
1579,20,OAXACA,20568,ZAPOTITLAN PALMAS,2,2,0,0,0,0,0,0,0,0,0,0,2,2,0,0
1580,20,OAXACA,20569,SANTA INES DE ZARAGOZA,0,0,0,0,0,0,0,0,0,0,0,0,0,0,0,0
1581,20,OAXACA,20570,ZIMATLAN DE ALVAREZ,0,0,0,0,0,0,0,0,0,0,0,0,0,0,0,0
1582,21,PUEBLA,21001,ACAJETE,5,5,0,0,0,0,0,0,0,0,0,0,5,5,0,0
1583,21,PUEBLA,21002,ACATENO,0,0,0,0,0,0,0,0,0,0,0,0,0,0,0,0
1584,21,PUEBLA,21003,ACATLAN,1,1,0,0,0,0,0,0,0,0,0,0,1,1,0,0
1585,21,PUEBLA,21004,ACATZINGO,16,9,7,0,0,0,0,0,0,0,0,0,16,9,7,0
1586,21,PUEBLA,21005,ACTEOPAN,0,0,0,0,0,0,0,0,0,0,0,0,0,0,0,0
1587,21,PUEBLA,21006,AHUACATLAN,0,0,0,0,0,0,0,0,0,0,0,0,0,0,0,0
1588,21,PUEBLA,21007,AHUATLAN,0,0,0,0,0,0,0,0,0,0,0,0,0,0,0,0
1589,21,PUEBLA,21008,AHUAZOTEPEC,5,3,2,0,0,0,0,0,0,0,0,0,5,3,2,0
1590,21,PUEBLA,21009,AHUEHUETITLA,0,0,0,0,0,0,0,0,0,0,0,0,0,0,0,0
1591,21,PUEBLA,21010,AJALPAN,0,0,0,0,0,0,0,0,0,0,0,0,0,0,0,0
1592,21,PUEBLA,21011,ALBINO ZERTUCHE,0,0,0,0,0,0,0,0,0,0,0,0,0,0,0,0
1593,21,PUEBLA,21012,ALJOJUCA,1,1,0,0,0,0,0,0,0,0,0,0,1,1,0,0
1594,21,PUEBLA,21013,ALTEPEXI,0,0,0,0,0,0,0,0,0,0,0,0,0,0,0,0
1595,21,PUEBLA,21014,AMIXTLAN,0,0,0,0,0,0,0,0,0,0,0,0,0,0,0,0
1596,21,PUEBLA,21015,AMOZOC,20,11,9,0,0,0,0,0,0,0,0,0,20,11,9,0
1597,21,PUEBLA,21016,AQUIXTLA,0,0,0,0,0,0,0,0,0,0,0,0,0,0,0,0
1598,21,PUEBLA,21017,ATEMPAN,0,0,0,0,0,0,0,0,0,0,0,0,0,0,0,0
1599,21,PUEBLA,21018,ATEXCAL,0,0,0,0,0,0,0,0,0,0,0,0,0,0,0,0
1600,21,PUEBLA,21019,ATLIXCO,7,7,0,0,0,0,0,0,0,0,0,0,7,7,0,0
1601,21,PUEBLA,21020,ATOYATEMPAN,0,0,0,0,0,0,0,0,0,0,0,0,0,0,0,0
1602,21,PUEBLA,21021,ATZALA,0,0,0,0,0,0,0,0,0,0,0,0,0,0,0,0
1603,21,PUEBLA,21022,ATZITZIHUACAN,2,2,0,0,0,0,0,0,0,0,0,0,2,2,0,0
1604,21,PUEBLA,21023,ATZITZINTLA,1,0,1,0,0,0,0,0,0,0,0,0,1,0,1,0
1605,21,PUEBLA,21024,AXUTLA,0,0,0,0,0,0,0,0,0,0,0,0,0,0,0,0
1606,21,PUEBLA,21025,AYOTOXCO DE GUERRERO,0,0,0,0,0,0,0,0,0,0,0,0,0,0,0,0
1607,21,PUEBLA,21026,CALPAN,0,0,0,0,0,0,0,0,0,0,0,0,0,0,0,0
1608,21,PUEBLA,21027,CALTEPEC,0,0,0,0,0,0,0,0,0,0,0,0,0,0,0,0
1609,21,PUEBLA,21028,CAMOCUAUTLA,0,0,0,0,0,0,0,0,0,0,0,0,0,0,0,0
1610,21,PUEBLA,21029,CAXHUACAN,0,0,0,0,0,0,0,0,0,0,0,0,0,0,0,0
1611,21,PUEBLA,21030,COATEPEC,0,0,0,0,0,0,0,0,0,0,0,0,0,0,0,0
1612,21,PUEBLA,21031,COATZINGO,0,0,0,0,0,0,0,0,0,0,0,0,0,0,0,0
1613,21,PUEBLA,21032,COHETZALA,0,0,0,0,0,0,0,0,0,0,0,0,0,0,0,0
1614,21,PUEBLA,21033,COHUECAN,1,1,0,0,0,0,0,0,0,0,0,0,1,1,0,0
1615,21,PUEBLA,21034,CORONANGO,25,16,9,0,0,0,0,0,0,0,0,0,25,16,9,0
1616,21,PUEBLA,21035,COXCATLAN,0,0,0,0,0,0,0,0,0,0,0,0,0,0,0,0
1617,21,PUEBLA,21036,COYOMEAPAN,0,0,0,0,0,0,0,0,0,0,0,0,0,0,0,0
1618,21,PUEBLA,21037,COYOTEPEC,0,0,0,0,0,0,0,0,0,0,0,0,0,0,0,0
1619,21,PUEBLA,21038,CUAPIAXTLA DE MADERO,10,7,3,0,0,0,0,0,0,0,0,0,10,7,3,0
1620,21,PUEBLA,21039,CUAUTEMPAN,0,0,0,0,0,0,0,0,0,0,0,0,0,0,0,0
1621,21,PUEBLA,21040,CUAUTINCHAN,0,0,0,0,0,0,0,0,0,0,0,0,0,0,0,0
1622,21,PUEBLA,21041,CUAUTLANCINGO,7,4,3,0,0,0,0,0,0,0,0,0,7,4,3,0
1623,21,PUEBLA,21042,CUAYUCA DE ANDRADE,0,0,0,0,0,0,0,0,0,0,0,0,0,0,0,0
1624,21,PUEBLA,21043,CUETZALAN DEL PROGRESO,0,0,0,0,0,0,0,0,0,0,0,0,0,0,0,0
1625,21,PUEBLA,21044,CUYOACO,0,0,0,0,0,0,0,0,0,0,0,0,0,0,0,0
1626,21,PUEBLA,21045,CHALCHICOMULA DE SESMA,6,4,2,0,0,0,0,0,0,0,0,0,6,4,2,0
1627,21,PUEBLA,21046,CHAPULCO,0,0,0,0,0,0,0,0,0,0,0,0,0,0,0,0
1628,21,PUEBLA,21047,CHIAUTLA,0,0,0,0,0,0,0,0,0,0,0,0,0,0,0,0
1629,21,PUEBLA,21048,CHIAUTZINGO,0,0,0,0,0,0,0,0,0,0,0,0,0,0,0,0
1630,21,PUEBLA,21049,CHICONCUAUTLA,0,0,0,0,0,0,0,0,0,0,0,0,0,0,0,0
1631,21,PUEBLA,21050,CHICHIQUILA,0,0,0,0,0,0,0,0,0,0,0,0,0,0,0,0
1632,21,PUEBLA,21051,CHIETLA,0,0,0,0,0,0,0,0,0,0,0,0,0,0,0,0
1633,21,PUEBLA,21052,CHIGMECATITLAN,0,0,0,0,0,0,0,0,0,0,0,0,0,0,0,0
1634,21,PUEBLA,21053,CHIGNAHUAPAN,7,3,4,0,0,0,0,0,0,0,0,0,7,3,4,0
1635,21,PUEBLA,21054,CHIGNAUTLA,1,1,0,0,0,0,0,0,0,0,0,0,1,1,0,0
1636,21,PUEBLA,21055,CHILA,0,0,0,0,0,0,0,0,0,0,0,0,0,0,0,0
1637,21,PUEBLA,21056,CHILA DE LA SAL,0,0,0,0,0,0,0,0,0,0,0,0,0,0,0,0
1638,21,PUEBLA,21057,HONEY,1,1,0,0,0,0,0,0,0,0,0,0,1,1,0,0
1639,21,PUEBLA,21058,CHILCHOTLA,0,0,0,0,0,0,0,0,0,0,0,0,0,0,0,0
1640,21,PUEBLA,21059,CHINANTLA,0,0,0,0,0,0,0,0,0,0,0,0,0,0,0,0
1641,21,PUEBLA,21060,DOMINGO ARENAS,0,0,0,0,0,0,0,0,0,0,0,0,0,0,0,0
1642,21,PUEBLA,21061,ELOXOCHITLAN,0,0,0,0,0,0,0,0,0,0,0,0,0,0,0,0
1643,21,PUEBLA,21062,EPATLAN,0,0,0,0,0,0,0,0,0,0,0,0,0,0,0,0
1644,21,PUEBLA,21063,ESPERANZA,14,7,7,0,0,0,0,0,0,0,0,0,14,7,7,0
1645,21,PUEBLA,21064,FRANCISCO Z MENA,0,0,0,0,0,0,0,0,0,0,0,0,0,0,0,0
1646,21,PUEBLA,21065,GENERAL FELIPE ANGELES,4,4,0,0,0,0,0,0,0,0,0,0,4,4,0,0
1647,21,PUEBLA,21066,GUADALUPE,0,0,0,0,0,0,0,0,0,0,0,0,0,0,0,0
1648,21,PUEBLA,21067,GUADALUPE VICTORIA,0,0,0,0,0,0,0,0,0,0,0,0,0,0,0,0
1649,21,PUEBLA,21068,HERMENEGILDO GALEANA,0,0,0,0,0,0,0,0,0,0,0,0,0,0,0,0
1650,21,PUEBLA,21069,HUAQUECHULA,0,0,0,0,0,0,0,0,0,0,0,0,0,0,0,0
1651,21,PUEBLA,21070,HUATLATLAUCA,0,0,0,0,0,0,0,0,0,0,0,0,0,0,0,0
1652,21,PUEBLA,21071,HUAUCHINANGO,12,8,4,0,0,0,0,0,0,0,0,0,12,8,4,0
1653,21,PUEBLA,21072,HUEHUETLA,0,0,0,0,0,0,0,0,0,0,0,0,0,0,0,0
1654,21,PUEBLA,21073,HUEHUETLAN EL CHICO,0,0,0,0,0,0,0,0,0,0,0,0,0,0,0,0
1655,21,PUEBLA,21074,HUEJOTZINGO,30,11,19,0,3,0,3,0,0,0,0,0,27,11,16,0
1656,21,PUEBLA,21075,HUEYAPAN,0,0,0,0,0,0,0,0,0,0,0,0,0,0,0,0
1657,21,PUEBLA,21076,HUEYTAMALCO,0,0,0,0,0,0,0,0,0,0,0,0,0,0,0,0
1658,21,PUEBLA,21077,HUEYTLALPAN,0,0,0,0,0,0,0,0,0,0,0,0,0,0,0,0
1659,21,PUEBLA,21078,HUITZILAN DE SERDAN,0,0,0,0,0,0,0,0,0,0,0,0,0,0,0,0
1660,21,PUEBLA,21079,HUITZILTEPEC,0,0,0,0,0,0,0,0,0,0,0,0,0,0,0,0
1661,21,PUEBLA,21080,ATLEQUIZAYAN,0,0,0,0,0,0,0,0,0,0,0,0,0,0,0,0
1662,21,PUEBLA,21081,IXCAMILPA DE GUERRERO,0,0,0,0,0,0,0,0,0,0,0,0,0,0,0,0
1663,21,PUEBLA,21082,IXCAQUIXTLA,0,0,0,0,0,0,0,0,0,0,0,0,0,0,0,0
1664,21,PUEBLA,21083,IXTACAMAXTITLAN,0,0,0,0,0,0,0,0,0,0,0,0,0,0,0,0
1665,21,PUEBLA,21084,IXTEPEC,0,0,0,0,0,0,0,0,0,0,0,0,0,0,0,0
1666,21,PUEBLA,21085,IZUCAR DE MATAMOROS,4,1,3,0,0,0,0,0,0,0,0,0,4,1,3,0
1667,21,PUEBLA,21086,JALPAN,6,2,4,0,0,0,0,0,0,0,0,0,6,2,4,0
1668,21,PUEBLA,21087,JOLALPAN,0,0,0,0,0,0,0,0,0,0,0,0,0,0,0,0
1669,21,PUEBLA,21088,JONOTLA,0,0,0,0,0,0,0,0,0,0,0,0,0,0,0,0
1670,21,PUEBLA,21089,JOPALA,0,0,0,0,0,0,0,0,0,0,0,0,0,0,0,0
1671,21,PUEBLA,21090,JUAN C BONILLA,0,0,0,0,0,0,0,0,0,0,0,0,0,0,0,0
1672,21,PUEBLA,21091,JUAN GALINDO,0,0,0,0,0,0,0,0,0,0,0,0,0,0,0,0
1673,21,PUEBLA,21092,JUAN N MENDEZ,0,0,0,0,0,0,0,0,0,0,0,0,0,0,0,0
1674,21,PUEBLA,21093,LAFRAGUA,0,0,0,0,0,0,0,0,0,0,0,0,0,0,0,0
1675,21,PUEBLA,21094,LIBRES,6,4,2,0,0,0,0,0,0,0,0,0,6,4,2,0
1676,21,PUEBLA,21095,LA MAGDALENA TLATLAUQUITEPEC,0,0,0,0,0,0,0,0,0,0,0,0,0,0,0,0
1677,21,PUEBLA,21096,MAZAPILTEPEC DE JUAREZ,0,0,0,0,0,0,0,0,0,0,0,0,0,0,0,0
1678,21,PUEBLA,21097,MIXTLA,0,0,0,0,0,0,0,0,0,0,0,0,0,0,0,0
1679,21,PUEBLA,21098,MOLCAXAC,0,0,0,0,0,0,0,0,0,0,0,0,0,0,0,0
1680,21,PUEBLA,21099,CAÑADA MORELOS,3,2,1,0,0,0,0,0,0,0,0,0,3,2,1,0
1681,21,PUEBLA,21100,NAUPAN,0,0,0,0,0,0,0,0,0,0,0,0,0,0,0,0
1682,21,PUEBLA,21101,NAUZONTLA,0,0,0,0,0,0,0,0,0,0,0,0,0,0,0,0
1683,21,PUEBLA,21102,NEALTICAN,0,0,0,0,0,0,0,0,0,0,0,0,0,0,0,0
1684,21,PUEBLA,21103,NICOLAS BRAVO,4,0,4,0,0,0,0,0,0,0,0,0,4,0,4,0
1685,21,PUEBLA,21104,NOPALUCAN,0,0,0,0,0,0,0,0,0,0,0,0,0,0,0,0
1686,21,PUEBLA,21105,OCOTEPEC,1,0,1,0,0,0,0,0,0,0,0,0,1,0,1,0
1687,21,PUEBLA,21106,OCOYUCAN,0,0,0,0,0,0,0,0,0,0,0,0,0,0,0,0
1688,21,PUEBLA,21107,OLINTLA,0,0,0,0,0,0,0,0,0,0,0,0,0,0,0,0
1689,21,PUEBLA,21108,ORIENTAL,47,31,16,0,0,0,0,0,0,0,0,0,47,31,16,0
1690,21,PUEBLA,21109,PAHUATLAN,0,0,0,0,0,0,0,0,0,0,0,0,0,0,0,0
1691,21,PUEBLA,21110,PALMAR DE BRAVO,14,9,5,0,0,0,0,0,0,0,0,0,14,9,5,0
1692,21,PUEBLA,21111,PANTEPEC,0,0,0,0,0,0,0,0,0,0,0,0,0,0,0,0
1693,21,PUEBLA,21112,PETLALCINGO,0,0,0,0,0,0,0,0,0,0,0,0,0,0,0,0
1694,21,PUEBLA,21113,PIAXTLA,0,0,0,0,0,0,0,0,0,0,0,0,0,0,0,0
1695,21,PUEBLA,21114,PUEBLA,15,12,3,0,0,0,0,0,0,0,0,0,15,12,3,0
1696,21,PUEBLA,21115,QUECHOLAC,4,3,1,0,0,0,0,0,0,0,0,0,4,3,1,0
1697,21,PUEBLA,21116,QUIMIXTLAN,0,0,0,0,0,0,0,0,0,0,0,0,0,0,0,0
1698,21,PUEBLA,21117,RAFAEL LARA GRAJALES,1,1,0,0,0,0,0,0,0,0,0,0,1,1,0,0
1699,21,PUEBLA,21118,LOS REYES DE JUAREZ,8,7,1,0,0,0,0,0,0,0,0,0,8,7,1,0
1700,21,PUEBLA,21119,SAN ANDRES CHOLULA,0,0,0,0,0,0,0,0,0,0,0,0,0,0,0,0
1701,21,PUEBLA,21120,SAN ANTONIO CAÑADA,0,0,0,0,0,0,0,0,0,0,0,0,0,0,0,0
1702,21,PUEBLA,21121,SAN DIEGO LA MESA TOCHIMILTZINGO,0,0,0,0,0,0,0,0,0,0,0,0,0,0,0,0
1703,21,PUEBLA,21122,SAN FELIPE TEOTLALCINGO,0,0,0,0,0,0,0,0,0,0,0,0,0,0,0,0
1704,21,PUEBLA,21123,SAN FELIPE TEPATLAN,0,0,0,0,0,0,0,0,0,0,0,0,0,0,0,0
1705,21,PUEBLA,21124,SAN GABRIEL CHILAC,0,0,0,0,0,0,0,0,0,0,0,0,0,0,0,0
1706,21,PUEBLA,21125,SAN GREGORIO ATZOMPA,0,0,0,0,0,0,0,0,0,0,0,0,0,0,0,0
1707,21,PUEBLA,21126,SAN JERONIMO TECUANIPAN,0,0,0,0,0,0,0,0,0,0,0,0,0,0,0,0
1708,21,PUEBLA,21127,SAN JERONIMO XAYACATLAN,0,0,0,0,0,0,0,0,0,0,0,0,0,0,0,0
1709,21,PUEBLA,21128,SAN JOSE CHIAPA,1,1,0,0,0,0,0,0,0,0,0,0,1,1,0,0
1710,21,PUEBLA,21129,SAN JOSE MIAHUATLAN,1,1,0,0,0,0,0,0,0,0,0,0,1,1,0,0
1711,21,PUEBLA,21130,SAN JUAN ATENCO,0,0,0,0,0,0,0,0,0,0,0,0,0,0,0,0
1712,21,PUEBLA,21131,SAN JUAN ATZOMPA,0,0,0,0,0,0,0,0,0,0,0,0,0,0,0,0
1713,21,PUEBLA,21132,SAN MARTIN TEXMELUCAN,155,80,75,0,0,0,0,0,0,0,0,0,155,80,75,0
1714,21,PUEBLA,21133,SAN MARTIN TOTOLTEPEC,1,0,1,0,0,0,0,0,0,0,0,0,1,0,1,0
1715,21,PUEBLA,21134,SAN MATIAS TLALANCALECA,7,7,0,0,0,0,0,0,0,0,0,0,7,7,0,0
1716,21,PUEBLA,21135,SAN MIGUEL IXITLAN,0,0,0,0,0,0,0,0,0,0,0,0,0,0,0,0
1717,21,PUEBLA,21136,SAN MIGUEL XOXTLA,18,8,10,0,0,0,0,0,0,0,0,0,18,8,10,0
1718,21,PUEBLA,21137,SAN NICOLAS BUENOS AIRES,8,5,3,0,0,0,0,0,0,0,0,0,8,5,3,0
1719,21,PUEBLA,21138,SAN NICOLAS DE LOS RANCHOS,0,0,0,0,0,0,0,0,0,0,0,0,0,0,0,0
1720,21,PUEBLA,21139,SAN PABLO ANICANO,0,0,0,0,0,0,0,0,0,0,0,0,0,0,0,0
1721,21,PUEBLA,21140,SAN PEDRO CHOLULA,1,1,0,0,0,0,0,0,0,0,0,0,1,1,0,0
1722,21,PUEBLA,21141,SAN PEDRO YELOIXTLAHUACA,0,0,0,0,0,0,0,0,0,0,0,0,0,0,0,0
1723,21,PUEBLA,21142,SAN SALVADOR EL SECO,1,1,0,0,0,0,0,0,0,0,0,0,1,1,0,0
1724,21,PUEBLA,21143,SAN SALVADOR EL VERDE,6,3,3,0,0,0,0,0,0,0,0,0,6,3,3,0
1725,21,PUEBLA,21144,SAN SALVADOR HUIXCOLOTLA,9,5,4,0,0,0,0,0,0,0,0,0,9,5,4,0
1726,21,PUEBLA,21145,SAN SEBASTIAN TLACOTEPEC,0,0,0,0,0,0,0,0,0,0,0,0,0,0,0,0
1727,21,PUEBLA,21146,SANTA CATARINA TLALTEMPAN,0,0,0,0,0,0,0,0,0,0,0,0,0,0,0,0
1728,21,PUEBLA,21147,SANTA INES AHUATEMPAN,0,0,0,0,0,0,0,0,0,0,0,0,0,0,0,0
1729,21,PUEBLA,21148,SANTA ISABEL CHOLULA,4,0,4,0,0,0,0,0,0,0,0,0,4,0,4,0
1730,21,PUEBLA,21149,SANTIAGO MIAHUATLAN,1,0,1,0,0,0,0,0,0,0,0,0,1,0,1,0
1731,21,PUEBLA,21150,HUEHUETLAN EL GRANDE,0,0,0,0,0,0,0,0,0,0,0,0,0,0,0,0
1732,21,PUEBLA,21151,SANTO TOMAS HUEYOTLIPAN,0,0,0,0,0,0,0,0,0,0,0,0,0,0,0,0
1733,21,PUEBLA,21152,SOLTEPEC,0,0,0,0,0,0,0,0,0,0,0,0,0,0,0,0
1734,21,PUEBLA,21153,TECALI DE HERRERA,0,0,0,0,0,0,0,0,0,0,0,0,0,0,0,0
1735,21,PUEBLA,21154,TECAMACHALCO,33,18,15,0,0,0,0,0,0,0,0,0,33,18,15,0
1736,21,PUEBLA,21155,TECOMATLAN,0,0,0,0,0,0,0,0,0,0,0,0,0,0,0,0
1737,21,PUEBLA,21156,TEHUACAN,22,4,18,0,0,0,0,0,0,0,0,0,22,4,18,0
1738,21,PUEBLA,21157,TEHUITZINGO,1,0,1,0,0,0,0,0,0,0,0,0,1,0,1,0
1739,21,PUEBLA,21158,TENAMPULCO,0,0,0,0,0,0,0,0,0,0,0,0,0,0,0,0
1740,21,PUEBLA,21159,TEOPANTLAN,0,0,0,0,0,0,0,0,0,0,0,0,0,0,0,0
1741,21,PUEBLA,21160,TEOTLALCO,0,0,0,0,0,0,0,0,0,0,0,0,0,0,0,0
1742,21,PUEBLA,21161,TEPANCO DE LOPEZ,8,1,7,0,0,0,0,0,0,0,0,0,8,1,7,0
1743,21,PUEBLA,21162,TEPANGO DE RODRIGUEZ,0,0,0,0,0,0,0,0,0,0,0,0,0,0,0,0
1744,21,PUEBLA,21163,TEPATLAXCO DE HIDALGO,2,0,2,0,0,0,0,0,0,0,0,0,2,0,2,0
1745,21,PUEBLA,21164,TEPEACA,27,15,12,0,0,0,0,0,0,0,0,0,27,15,12,0
1746,21,PUEBLA,21165,TEPEMAXALCO,0,0,0,0,0,0,0,0,0,0,0,0,0,0,0,0
1747,21,PUEBLA,21166,TEPEOJUMA,0,0,0,0,0,0,0,0,0,0,0,0,0,0,0,0
1748,21,PUEBLA,21167,TEPETZINTLA,0,0,0,0,0,0,0,0,0,0,0,0,0,0,0,0
1749,21,PUEBLA,21168,TEPEXCO,0,0,0,0,0,0,0,0,0,0,0,0,0,0,0,0
1750,21,PUEBLA,21169,TEPEXI DE RODRIGUEZ,0,0,0,0,0,0,0,0,0,0,0,0,0,0,0,0
1751,21,PUEBLA,21170,TEPEYAHUALCO,4,4,0,0,0,0,0,0,0,0,0,0,4,4,0,0
1752,21,PUEBLA,21171,TEPEYAHUALCO DE CUAUHTEMOC,0,0,0,0,0,0,0,0,0,0,0,0,0,0,0,0
1753,21,PUEBLA,21172,TETELA DE OCAMPO,0,0,0,0,0,0,0,0,0,0,0,0,0,0,0,0
1754,21,PUEBLA,21173,TETELES DE AVILA CASTILLO,0,0,0,0,0,0,0,0,0,0,0,0,0,0,0,0
1755,21,PUEBLA,21174,TEZIUTLAN,2,2,0,0,0,0,0,0,0,0,0,0,2,2,0,0
1756,21,PUEBLA,21175,TIANGUISMANALCO,0,0,0,0,0,0,0,0,0,0,0,0,0,0,0,0
1757,21,PUEBLA,21176,TILAPA,1,1,0,0,0,0,0,0,0,0,0,0,1,1,0,0
1758,21,PUEBLA,21177,TLACOTEPEC DE BENITO JUAREZ,5,3,2,0,0,0,0,0,0,0,0,0,5,3,2,0
1759,21,PUEBLA,21178,TLACUILOTEPEC,0,0,0,0,0,0,0,0,0,0,0,0,0,0,0,0
1760,21,PUEBLA,21179,TLACHICHUCA,0,0,0,0,0,0,0,0,0,0,0,0,0,0,0,0
1761,21,PUEBLA,21180,TLAHUAPAN,9,8,1,0,0,0,0,0,0,0,0,0,9,8,1,0
1762,21,PUEBLA,21181,TLALTENANGO,0,0,0,0,0,0,0,0,0,0,0,0,0,0,0,0
1763,21,PUEBLA,21182,TLANEPANTLA,0,0,0,0,0,0,0,0,0,0,0,0,0,0,0,0
1764,21,PUEBLA,21183,TLAOLA,0,0,0,0,0,0,0,0,0,0,0,0,0,0,0,0
1765,21,PUEBLA,21184,TLAPACOYA,0,0,0,0,0,0,0,0,0,0,0,0,0,0,0,0
1766,21,PUEBLA,21185,TLAPANALA,0,0,0,0,0,0,0,0,0,0,0,0,0,0,0,0
1767,21,PUEBLA,21186,TLATLAUQUITEPEC,1,0,1,0,0,0,0,0,0,0,0,0,1,0,1,0
1768,21,PUEBLA,21187,TLAXCO,0,0,0,0,0,0,0,0,0,0,0,0,0,0,0,0
1769,21,PUEBLA,21188,TOCHIMILCO,0,0,0,0,0,0,0,0,0,0,0,0,0,0,0,0
1770,21,PUEBLA,21189,TOCHTEPEC,0,0,0,0,0,0,0,0,0,0,0,0,0,0,0,0
1771,21,PUEBLA,21190,TOTOLTEPEC DE GUERRERO,0,0,0,0,0,0,0,0,0,0,0,0,0,0,0,0
1772,21,PUEBLA,21191,TULCINGO,0,0,0,0,0,0,0,0,0,0,0,0,0,0,0,0
1773,21,PUEBLA,21192,TUZAMAPAN DE GALEANA,0,0,0,0,0,0,0,0,0,0,0,0,0,0,0,0
1774,21,PUEBLA,21193,TZICATLACOYAN,0,0,0,0,0,0,0,0,0,0,0,0,0,0,0,0
1775,21,PUEBLA,21194,VENUSTIANO CARRANZA,1,0,1,0,0,0,0,0,0,0,0,0,1,0,1,0
1776,21,PUEBLA,21195,VICENTE GUERRERO,0,0,0,0,0,0,0,0,0,0,0,0,0,0,0,0
1777,21,PUEBLA,21196,XAYACATLAN DE BRAVO,0,0,0,0,0,0,0,0,0,0,0,0,0,0,0,0
1778,21,PUEBLA,21197,XICOTEPEC,1,1,0,0,0,0,0,0,0,0,0,0,1,1,0,0
1779,21,PUEBLA,21198,XICOTLAN,0,0,0,0,0,0,0,0,0,0,0,0,0,0,0,0
1780,21,PUEBLA,21199,XIUTETELCO,0,0,0,0,0,0,0,0,0,0,0,0,0,0,0,0
1781,21,PUEBLA,21200,XOCHIAPULCO,0,0,0,0,0,0,0,0,0,0,0,0,0,0,0,0
1782,21,PUEBLA,21201,XOCHILTEPEC,0,0,0,0,0,0,0,0,0,0,0,0,0,0,0,0
1783,21,PUEBLA,21202,XOCHITLAN DE VICENTE SUAREZ,0,0,0,0,0,0,0,0,0,0,0,0,0,0,0,0
1784,21,PUEBLA,21203,XOCHITLAN TODOS SANTOS,0,0,0,0,0,0,0,0,0,0,0,0,0,0,0,0
1785,21,PUEBLA,21204,YAONAHUAC,0,0,0,0,0,0,0,0,0,0,0,0,0,0,0,0
1786,21,PUEBLA,21205,YEHUALTEPEC,6,5,1,0,0,0,0,0,0,0,0,0,6,5,1,0
1787,21,PUEBLA,21206,ZACAPALA,0,0,0,0,0,0,0,0,0,0,0,0,0,0,0,0
1788,21,PUEBLA,21207,ZACAPOAXTLA,0,0,0,0,0,0,0,0,0,0,0,0,0,0,0,0
1789,21,PUEBLA,21208,ZACATLAN,27,19,8,0,0,0,0,0,0,0,0,0,27,19,8,0
1790,21,PUEBLA,21209,ZAPOTITLAN,0,0,0,0,0,0,0,0,0,0,0,0,0,0,0,0
1791,21,PUEBLA,21210,ZAPOTITLAN DE MENDEZ,2,0,2,0,0,0,0,0,0,0,0,0,2,0,2,0
1792,21,PUEBLA,21211,ZARAGOZA,3,0,3,0,0,0,0,0,0,0,0,0,3,0,3,0
1793,21,PUEBLA,21212,ZAUTLA,0,0,0,0,0,0,0,0,0,0,0,0,0,0,0,0
1794,21,PUEBLA,21213,ZIHUATEUTLA,0,0,0,0,0,0,0,0,0,0,0,0,0,0,0,0
1795,21,PUEBLA,21214,ZINACATEPEC,0,0,0,0,0,0,0,0,0,0,0,0,0,0,0,0
1796,21,PUEBLA,21215,ZONGOZOTLA,0,0,0,0,0,0,0,0,0,0,0,0,0,0,0,0
1797,21,PUEBLA,21216,ZOQUIAPAN,0,0,0,0,0,0,0,0,0,0,0,0,0,0,0,0
1798,21,PUEBLA,21217,ZOQUITLAN,0,0,0,0,0,0,0,0,0,0,0,0,0,0,0,0
1799,22,QUERETARO,22001,AMEALCO DE BONFIL,4,1,3,0,0,0,0,0,0,0,0,0,4,1,3,0
1800,22,QUERETARO,22002,PINAL DE AMOLES,0,0,0,0,0,0,0,0,0,0,0,0,0,0,0,0
1801,22,QUERETARO,22003,ARROYO SECO,0,0,0,0,0,0,0,0,0,0,0,0,0,0,0,0
1802,22,QUERETARO,22004,CADEREYTA DE MONTES,5,2,3,0,0,0,0,0,0,0,0,0,5,2,3,0
1803,22,QUERETARO,22005,COLON,6,5,1,0,1,0,1,0,0,0,0,0,5,5,0,0
1804,22,QUERETARO,22006,CORREGIDORA,9,8,1,0,0,0,0,0,0,0,0,0,9,8,1,0
1805,22,QUERETARO,22007,EZEQUIEL MONTES,2,2,0,0,0,0,0,0,0,0,0,0,2,2,0,0
1806,22,QUERETARO,22008,HUIMILPAN,3,1,2,0,0,0,0,0,0,0,0,0,3,1,2,0
1807,22,QUERETARO,22009,JALPAN DE SERRA,0,0,0,0,0,0,0,0,0,0,0,0,0,0,0,0
1808,22,QUERETARO,22010,LANDA DE MATAMOROS,0,0,0,0,0,0,0,0,0,0,0,0,0,0,0,0
1809,22,QUERETARO,22011,EL MARQUES,55,39,16,0,0,0,0,0,0,0,0,0,55,39,16,0
1810,22,QUERETARO,22012,PEDRO ESCOBEDO,16,8,8,0,0,0,0,0,0,0,0,0,16,8,8,0
1811,22,QUERETARO,22013,PEÑAMILLER,0,0,0,0,0,0,0,0,0,0,0,0,0,0,0,0
1812,22,QUERETARO,22014,QUERETARO,134,100,34,0,0,0,0,0,0,0,0,0,134,100,34,0
1813,22,QUERETARO,22015,SAN JOAQUIN,0,0,0,0,0,0,0,0,0,0,0,0,0,0,0,0
1814,22,QUERETARO,22016,SAN JUAN DEL RIO,180,110,70,0,0,0,0,0,0,0,0,0,180,110,70,0
1815,22,QUERETARO,22017,TEQUISQUIAPAN,3,2,1,0,0,0,0,0,0,0,0,0,3,2,1,0
1816,22,QUERETARO,22018,TOLIMAN,0,0,0,0,0,0,0,0,0,0,0,0,0,0,0,0
1817,23,QUINTANA ROO,23001,COZUMEL,0,0,0,0,0,0,0,0,0,0,0,0,0,0,0,0
1818,23,QUINTANA ROO,23002,FELIPE CARRILLO PUERTO,19,10,9,0,0,0,0,0,0,0,0,0,19,10,9,0
1819,23,QUINTANA ROO,23003,ISLA MUJERES,0,0,0,0,0,0,0,0,0,0,0,0,0,0,0,0
1820,23,QUINTANA ROO,23004,OTHON P BLANCO,81,54,27,0,0,0,0,0,0,0,0,0,81,54,27,0
1821,23,QUINTANA ROO,23005,BENITO JUAREZ,59,34,25,0,0,0,0,0,0,0,0,0,59,34,25,0
1822,23,QUINTANA ROO,23006,JOSE MARIA MORELOS,2,2,0,0,0,0,0,0,0,0,0,0,2,2,0,0
1823,23,QUINTANA ROO,23007,LAZARO CARDENAS,3,1,2,0,0,0,0,0,0,0,0,0,3,1,2,0
1824,23,QUINTANA ROO,23008,SOLIDARIDAD,35,15,20,0,0,0,0,0,0,0,0,0,35,15,20,0
1825,23,QUINTANA ROO,23009,TULUM,1,1,0,0,0,0,0,0,0,0,0,0,1,1,0,0
1826,23,QUINTANA ROO,23010,BACALAR,0,0,0,0,0,0,0,0,0,0,0,0,0,0,0,0
1827,23,QUINTANA ROO,23011,PUERTO MORELOS,10,8,2,0,0,0,0,0,0,0,0,0,10,8,2,0
1828,24,SAN LUIS POTOSI,24001,AHUALULCO DEL SONIDO 13,1,1,0,0,0,0,0,0,0,0,0,0,1,1,0,0
1829,24,SAN LUIS POTOSI,24002,ALAQUINES,0,0,0,0,0,0,0,0,0,0,0,0,0,0,0,0
1830,24,SAN LUIS POTOSI,24003,AQUISMON,2,0,2,0,0,0,0,0,0,0,0,0,2,0,2,0
1831,24,SAN LUIS POTOSI,24004,ARMADILLO DE LOS INFANTE,0,0,0,0,0,0,0,0,0,0,0,0,0,0,0,0
1832,24,SAN LUIS POTOSI,24005,CARDENAS,0,0,0,0,0,0,0,0,0,0,0,0,0,0,0,0
1833,24,SAN LUIS POTOSI,24006,CATORCE,0,0,0,0,0,0,0,0,0,0,0,0,0,0,0,0
1834,24,SAN LUIS POTOSI,24007,CEDRAL,3,3,0,0,0,0,0,0,0,0,0,0,3,3,0,0
1835,24,SAN LUIS POTOSI,24008,CERRITOS,0,0,0,0,0,0,0,0,0,0,0,0,0,0,0,0
1836,24,SAN LUIS POTOSI,24009,CERRO DE SAN PEDRO,0,0,0,0,0,0,0,0,0,0,0,0,0,0,0,0
1837,24,SAN LUIS POTOSI,24010,CIUDAD DEL MAIZ,1,1,0,0,0,0,0,0,0,0,0,0,1,1,0,0
1838,24,SAN LUIS POTOSI,24011,CIUDAD FERNANDEZ,4,0,4,0,0,0,0,0,0,0,0,0,4,0,4,0
1839,24,SAN LUIS POTOSI,24012,TANCANHUITZ,0,0,0,0,0,0,0,0,0,0,0,0,0,0,0,0
1840,24,SAN LUIS POTOSI,24013,CIUDAD VALLES,19,3,16,0,0,0,0,0,0,0,0,0,19,3,16,0
1841,24,SAN LUIS POTOSI,24014,COXCATLAN,0,0,0,0,0,0,0,0,0,0,0,0,0,0,0,0
1842,24,SAN LUIS POTOSI,24015,CHARCAS,0,0,0,0,0,0,0,0,0,0,0,0,0,0,0,0
1843,24,SAN LUIS POTOSI,24016,EBANO,1,1,0,0,0,0,0,0,0,0,0,0,1,1,0,0
1844,24,SAN LUIS POTOSI,24017,GUADALCAZAR,31,14,17,0,0,0,0,0,0,0,0,0,31,14,17,0
1845,24,SAN LUIS POTOSI,24018,HUEHUETLAN,0,0,0,0,0,0,0,0,0,0,0,0,0,0,0,0
1846,24,SAN LUIS POTOSI,24019,LAGUNILLAS,0,0,0,0,0,0,0,0,0,0,0,0,0,0,0,0
1847,24,SAN LUIS POTOSI,24020,MATEHUALA,61,34,27,0,0,0,0,0,0,0,0,0,61,34,27,0
1848,24,SAN LUIS POTOSI,24021,MEXQUITIC DE CARMONA,11,8,3,0,0,0,0,0,0,0,0,0,11,8,3,0
1849,24,SAN LUIS POTOSI,24022,MOCTEZUMA,0,0,0,0,0,0,0,0,0,0,0,0,0,0,0,0
1850,24,SAN LUIS POTOSI,24023,RAYON,3,1,2,0,0,0,0,0,0,0,0,0,3,1,2,0
1851,24,SAN LUIS POTOSI,24024,RIOVERDE,16,10,6,0,0,0,0,0,0,0,0,0,16,10,6,0
1852,24,SAN LUIS POTOSI,24025,SALINAS,6,3,3,0,0,0,0,0,0,0,0,0,6,3,3,0
1853,24,SAN LUIS POTOSI,24026,SAN ANTONIO,0,0,0,0,0,0,0,0,0,0,0,0,0,0,0,0
1854,24,SAN LUIS POTOSI,24027,SAN CIRO DE ACOSTA,0,0,0,0,0,0,0,0,0,0,0,0,0,0,0,0
1855,24,SAN LUIS POTOSI,24028,SAN LUIS POTOSI,113,71,42,0,0,0,0,0,0,0,0,0,113,71,42,0
1856,24,SAN LUIS POTOSI,24029,SAN MARTIN CHALCHICUAUTLA,0,0,0,0,0,0,0,0,0,0,0,0,0,0,0,0
1857,24,SAN LUIS POTOSI,24030,SAN NICOLAS TOLENTINO,1,1,0,0,0,0,0,0,0,0,0,0,1,1,0,0
1858,24,SAN LUIS POTOSI,24031,SANTA CATARINA,0,0,0,0,0,0,0,0,0,0,0,0,0,0,0,0
1859,24,SAN LUIS POTOSI,24032,SANTA MARIA DEL RIO,29,17,12,0,0,0,0,0,0,0,0,0,29,17,12,0
1860,24,SAN LUIS POTOSI,24033,SANTO DOMINGO,0,0,0,0,0,0,0,0,0,0,0,0,0,0,0,0
1861,24,SAN LUIS POTOSI,24034,SAN VICENTE TANCUAYALAB,0,0,0,0,0,0,0,0,0,0,0,0,0,0,0,0
1862,24,SAN LUIS POTOSI,24035,SOLEDAD DE GRACIANO SANCHEZ,51,33,18,0,0,0,0,0,0,0,0,0,51,33,18,0
1863,24,SAN LUIS POTOSI,24036,TAMASOPO,2,0,2,0,0,0,0,0,0,0,0,0,2,0,2,0
1864,24,SAN LUIS POTOSI,24037,TAMAZUNCHALE,2,0,2,0,0,0,0,0,0,0,0,0,2,0,2,0
1865,24,SAN LUIS POTOSI,24038,TAMPACAN,0,0,0,0,0,0,0,0,0,0,0,0,0,0,0,0
1866,24,SAN LUIS POTOSI,24039,TAMPAMOLON CORONA,0,0,0,0,0,0,0,0,0,0,0,0,0,0,0,0
1867,24,SAN LUIS POTOSI,24040,TAMUIN,0,0,0,0,0,0,0,0,0,0,0,0,0,0,0,0
1868,24,SAN LUIS POTOSI,24041,TANLAJAS,4,0,4,0,0,0,0,0,0,0,0,0,4,0,4,0
1869,24,SAN LUIS POTOSI,24042,TANQUIAN DE ESCOBEDO,0,0,0,0,0,0,0,0,0,0,0,0,0,0,0,0
1870,24,SAN LUIS POTOSI,24043,TIERRA NUEVA,0,0,0,0,0,0,0,0,0,0,0,0,0,0,0,0
1871,24,SAN LUIS POTOSI,24044,VANEGAS,0,0,0,0,0,0,0,0,0,0,0,0,0,0,0,0
1872,24,SAN LUIS POTOSI,24045,VENADO,0,0,0,0,0,0,0,0,0,0,0,0,0,0,0,0
1873,24,SAN LUIS POTOSI,24046,VILLA DE ARRIAGA,10,10,0,0,0,0,0,0,0,0,0,0,10,10,0,0
1874,24,SAN LUIS POTOSI,24047,VILLA DE GUADALUPE,0,0,0,0,0,0,0,0,0,0,0,0,0,0,0,0
1875,24,SAN LUIS POTOSI,24048,VILLA DE LA PAZ,0,0,0,0,0,0,0,0,0,0,0,0,0,0,0,0
1876,24,SAN LUIS POTOSI,24049,VILLA DE RAMOS,0,0,0,0,0,0,0,0,0,0,0,0,0,0,0,0
1877,24,SAN LUIS POTOSI,24050,VILLA DE REYES,7,7,0,0,0,0,0,0,0,0,0,0,7,7,0,0
1878,24,SAN LUIS POTOSI,24051,VILLA HIDALGO,27,22,5,0,0,0,0,0,0,0,0,0,27,22,5,0
1879,24,SAN LUIS POTOSI,24052,VILLA JUAREZ,0,0,0,0,0,0,0,0,0,0,0,0,0,0,0,0
1880,24,SAN LUIS POTOSI,24053,AXTLA DE TERRAZAS,0,0,0,0,0,0,0,0,0,0,0,0,0,0,0,0
1881,24,SAN LUIS POTOSI,24054,XILITLA,1,0,1,0,0,0,0,0,0,0,0,0,1,0,1,0
1882,24,SAN LUIS POTOSI,24055,ZARAGOZA,20,14,6,0,0,0,0,0,0,0,0,0,20,14,6,0
1883,24,SAN LUIS POTOSI,24056,VILLA DE ARISTA,0,0,0,0,0,0,0,0,0,0,0,0,0,0,0,0
1884,24,SAN LUIS POTOSI,24057,MATLAPA,1,0,1,0,0,0,0,0,0,0,0,0,1,0,1,0
1885,24,SAN LUIS POTOSI,24058,EL NARANJO,0,0,0,0,0,0,0,0,0,0,0,0,0,0,0,0
1886,25,SINALOA,25001,AHOME,107,65,42,0,0,0,0,0,0,0,0,0,107,65,42,0
1887,25,SINALOA,25002,ANGOSTURA,17,5,12,0,0,0,0,0,0,0,0,0,17,5,12,0
1888,25,SINALOA,25003,BADIRAGUATO,0,0,0,0,0,0,0,0,0,0,0,0,0,0,0,0
1889,25,SINALOA,25004,CONCORDIA,9,5,4,0,0,0,0,0,0,0,0,0,9,5,4,0
1890,25,SINALOA,25005,COSALA,8,8,0,0,0,0,0,0,0,0,0,0,8,8,0,0
1891,25,SINALOA,25006,CULIACAN,270,35,235,0,0,0,0,0,0,0,0,0,270,35,235,0
1892,25,SINALOA,25007,CHOIX,0,0,0,0,0,0,0,0,0,0,0,0,0,0,0,0
1893,25,SINALOA,25008,ELOTA,63,22,41,0,0,0,0,0,0,0,0,0,63,22,41,0
1894,25,SINALOA,25009,ESCUINAPA,101,23,78,0,0,0,0,0,0,0,0,0,101,23,78,0
1895,25,SINALOA,25010,EL FUERTE,0,0,0,0,0,0,0,0,0,0,0,0,0,0,0,0
1896,25,SINALOA,25011,GUASAVE,31,14,17,0,0,0,0,0,0,0,0,0,31,14,17,0
1897,25,SINALOA,25012,MAZATLAN,282,122,160,0,0,0,0,0,0,0,0,0,282,122,160,0
1898,25,SINALOA,25013,MOCORITO,3,2,1,0,0,0,0,0,0,0,0,0,3,2,1,0
1899,25,SINALOA,25014,ROSARIO,3,3,0,0,0,0,0,0,0,0,0,0,3,3,0,0
1900,25,SINALOA,25015,SALVADOR ALVARADO,29,5,24,0,0,0,0,0,0,0,0,0,29,5,24,0
1901,25,SINALOA,25016,SAN IGNACIO,3,2,1,0,0,0,0,0,0,0,0,0,3,2,1,0
1902,25,SINALOA,25017,SINALOA,2,0,2,0,0,0,0,0,0,0,0,0,2,0,2,0
1903,25,SINALOA,25018,NAVOLATO,0,0,0,0,0,0,0,0,0,0,0,0,0,0,0,0
1904,26,SONORA,26001,ACONCHI,0,0,0,0,0,0,0,0,0,0,0,0,0,0,0,0
1905,26,SONORA,26002,AGUA PRIETA,23,11,12,0,0,0,0,0,0,0,0,0,23,11,12,0
1906,26,SONORA,26003,ALAMOS,0,0,0,0,0,0,0,0,0,0,0,0,0,0,0,0
1907,26,SONORA,26004,ALTAR,31,10,21,0,0,0,0,0,0,0,0,0,31,10,21,0
1908,26,SONORA,26005,ARIVECHI,0,0,0,0,0,0,0,0,0,0,0,0,0,0,0,0
1909,26,SONORA,26006,ARIZPE,0,0,0,0,0,0,0,0,0,0,0,0,0,0,0,0
1910,26,SONORA,26007,ATIL,5,0,5,0,0,0,0,0,0,0,0,0,5,0,5,0
1911,26,SONORA,26008,BACADEHUACHI,0,0,0,0,0,0,0,0,0,0,0,0,0,0,0,0
1912,26,SONORA,26009,BACANORA,0,0,0,0,0,0,0,0,0,0,0,0,0,0,0,0
1913,26,SONORA,26010,BACERAC,0,0,0,0,0,0,0,0,0,0,0,0,0,0,0,0
1914,26,SONORA,26011,BACOACHI,0,0,0,0,0,0,0,0,0,0,0,0,0,0,0,0
1915,26,SONORA,26012,BACUM,0,0,0,0,0,0,0,0,0,0,0,0,0,0,0,0
1916,26,SONORA,26013,BANAMICHI,0,0,0,0,0,0,0,0,0,0,0,0,0,0,0,0
1917,26,SONORA,26014,BAVIACORA,0,0,0,0,0,0,0,0,0,0,0,0,0,0,0,0
1918,26,SONORA,26015,BAVISPE,0,0,0,0,0,0,0,0,0,0,0,0,0,0,0,0
1919,26,SONORA,26016,BENJAMIN HILL,1,1,0,0,0,0,0,0,0,0,0,0,1,1,0,0
1920,26,SONORA,26017,CABORCA,26,10,16,0,0,0,0,0,0,0,0,0,26,10,16,0
1921,26,SONORA,26018,CAJEME,16,6,10,0,0,0,0,0,0,0,0,0,16,6,10,0
1922,26,SONORA,26019,CANANEA,10,5,5,0,0,0,0,0,0,0,0,0,10,5,5,0
1923,26,SONORA,26020,CARBO,14,10,4,0,0,0,0,0,0,0,0,0,14,10,4,0
1924,26,SONORA,26021,LA COLORADA,0,0,0,0,0,0,0,0,0,0,0,0,0,0,0,0
1925,26,SONORA,26022,CUCURPE,0,0,0,0,0,0,0,0,0,0,0,0,0,0,0,0
1926,26,SONORA,26023,CUMPAS,0,0,0,0,0,0,0,0,0,0,0,0,0,0,0,0
1927,26,SONORA,26024,DIVISADEROS,0,0,0,0,0,0,0,0,0,0,0,0,0,0,0,0
1928,26,SONORA,26025,EMPALME,1,1,0,0,0,0,0,0,0,0,0,0,1,1,0,0
1929,26,SONORA,26026,ETCHOJOA,0,0,0,0,0,0,0,0,0,0,0,0,0,0,0,0
1930,26,SONORA,26027,FRONTERAS,0,0,0,0,0,0,0,0,0,0,0,0,0,0,0,0
1931,26,SONORA,26028,GRANADOS,0,0,0,0,0,0,0,0,0,0,0,0,0,0,0,0
1932,26,SONORA,26029,GUAYMAS,46,36,10,0,0,0,0,0,0,0,0,0,46,36,10,0
1933,26,SONORA,26030,HERMOSILLO,42,22,20,0,1,0,1,0,0,0,0,0,41,22,19,0
1934,26,SONORA,26031,HUACHINERA,0,0,0,0,0,0,0,0,0,0,0,0,0,0,0,0
1935,26,SONORA,26032,HUASABAS,0,0,0,0,0,0,0,0,0,0,0,0,0,0,0,0
1936,26,SONORA,26033,HUATABAMPO,3,1,2,0,0,0,0,0,0,0,0,0,3,1,2,0
1937,26,SONORA,26034,HUEPAC,0,0,0,0,0,0,0,0,0,0,0,0,0,0,0,0
1938,26,SONORA,26035,IMURIS,0,0,0,0,0,0,0,0,0,0,0,0,0,0,0,0
1939,26,SONORA,26036,MAGDALENA,12,7,5,0,0,0,0,0,0,0,0,0,12,7,5,0
1940,26,SONORA,26037,MAZATAN,0,0,0,0,0,0,0,0,0,0,0,0,0,0,0,0
1941,26,SONORA,26038,MOCTEZUMA,0,0,0,0,0,0,0,0,0,0,0,0,0,0,0,0
1942,26,SONORA,26039,NACO,4,0,4,0,0,0,0,0,0,0,0,0,4,0,4,0
1943,26,SONORA,26040,NACORI CHICO,0,0,0,0,0,0,0,0,0,0,0,0,0,0,0,0
1944,26,SONORA,26041,NACOZARI DE GARCIA,0,0,0,0,0,0,0,0,0,0,0,0,0,0,0,0
1945,26,SONORA,26042,NAVOJOA,8,6,2,0,0,0,0,0,0,0,0,0,8,6,2,0
1946,26,SONORA,26043,NOGALES,80,23,57,0,2,0,2,0,0,0,0,0,78,23,55,0
1947,26,SONORA,26044,ONAVAS,0,0,0,0,0,0,0,0,0,0,0,0,0,0,0,0
1948,26,SONORA,26045,OPODEPE,10,7,3,0,0,0,0,0,0,0,0,0,10,7,3,0
1949,26,SONORA,26046,OQUITOA,0,0,0,0,0,0,0,0,0,0,0,0,0,0,0,0
1950,26,SONORA,26047,PITIQUITO,23,7,16,0,0,0,0,0,0,0,0,0,23,7,16,0
1951,26,SONORA,26048,PUERTO PEÑASCO,10,9,1,0,0,0,0,0,0,0,0,0,10,9,1,0
1952,26,SONORA,26049,QUIRIEGO,0,0,0,0,0,0,0,0,0,0,0,0,0,0,0,0
1953,26,SONORA,26050,RAYON,0,0,0,0,0,0,0,0,0,0,0,0,0,0,0,0
1954,26,SONORA,26051,ROSARIO,0,0,0,0,0,0,0,0,0,0,0,0,0,0,0,0
1955,26,SONORA,26052,SAHUARIPA,0,0,0,0,0,0,0,0,0,0,0,0,0,0,0,0
1956,26,SONORA,26053,SAN FELIPE DE JESUS,0,0,0,0,0,0,0,0,0,0,0,0,0,0,0,0
1957,26,SONORA,26054,SAN JAVIER,0,0,0,0,0,0,0,0,0,0,0,0,0,0,0,0
1958,26,SONORA,26055,SAN LUIS RIO COLORADO,37,28,9,0,0,0,0,0,0,0,0,0,37,28,9,0
1959,26,SONORA,26056,SAN MIGUEL DE HORCASITAS,16,7,9,0,0,0,0,0,0,0,0,0,16,7,9,0
1960,26,SONORA,26057,SAN PEDRO DE LA CUEVA,0,0,0,0,0,0,0,0,0,0,0,0,0,0,0,0
1961,26,SONORA,26058,SANTA ANA,24,15,9,0,0,0,0,0,0,0,0,0,24,15,9,0
1962,26,SONORA,26059,SANTA CRUZ,0,0,0,0,0,0,0,0,0,0,0,0,0,0,0,0
1963,26,SONORA,26060,SARIC,0,0,0,0,0,0,0,0,0,0,0,0,0,0,0,0
1964,26,SONORA,26061,SOYOPA,2,2,0,0,0,0,0,0,0,0,0,0,2,2,0,0
1965,26,SONORA,26062,SUAQUI GRANDE,0,0,0,0,0,0,0,0,0,0,0,0,0,0,0,0
1966,26,SONORA,26063,TEPACHE,0,0,0,0,0,0,0,0,0,0,0,0,0,0,0,0
1967,26,SONORA,26064,TRINCHERAS,10,6,4,0,0,0,0,0,0,0,0,0,10,6,4,0
1968,26,SONORA,26065,TUBUTAMA,3,1,2,0,0,0,0,0,0,0,0,0,3,1,2,0
1969,26,SONORA,26066,URES,2,2,0,0,0,0,0,0,0,0,0,0,2,2,0,0
1970,26,SONORA,26067,VILLA HIDALGO,0,0,0,0,0,0,0,0,0,0,0,0,0,0,0,0
1971,26,SONORA,26068,VILLA PESQUEIRA,0,0,0,0,0,0,0,0,0,0,0,0,0,0,0,0
1972,26,SONORA,26069,YECORA,0,0,0,0,0,0,0,0,0,0,0,0,0,0,0,0
1973,26,SONORA,26070,GENERAL PLUTARCO ELIAS CALLES,36,21,15,0,0,0,0,0,0,0,0,0,36,21,15,0
1974,26,SONORA,26071,BENITO JUAREZ,0,0,0,0,0,0,0,0,0,0,0,0,0,0,0,0
1975,26,SONORA,26072,SAN IGNACIO RIO MUERTO,0,0,0,0,0,0,0,0,0,0,0,0,0,0,0,0
1976,27,TABASCO,27001,BALANCAN,2,2,0,0,0,0,0,0,0,0,0,0,2,2,0,0
1977,27,TABASCO,27002,CARDENAS,64,13,51,0,0,0,0,0,0,0,0,0,64,13,51,0
1978,27,TABASCO,27003,CENTLA,1,1,0,0,0,0,0,0,0,0,0,0,1,1,0,0
1979,27,TABASCO,27004,CENTRO,80,12,68,0,4,0,4,0,0,0,0,0,76,12,64,0
1980,27,TABASCO,27005,COMALCALCO,6,4,2,0,0,0,0,0,0,0,0,0,6,4,2,0
1981,27,TABASCO,27006,CUNDUACAN,43,14,29,0,0,0,0,0,0,0,0,0,43,14,29,0
1982,27,TABASCO,27007,EMILIANO ZAPATA,7,5,2,0,0,0,0,0,0,0,0,0,7,5,2,0
1983,27,TABASCO,27008,HUIMANGUILLO,151,22,129,0,0,0,0,0,0,0,0,0,151,22,129,0
1984,27,TABASCO,27009,JALAPA,0,0,0,0,0,0,0,0,0,0,0,0,0,0,0,0
1985,27,TABASCO,27010,JALPA DE MENDEZ,0,0,0,0,0,0,0,0,0,0,0,0,0,0,0,0
1986,27,TABASCO,27011,JONUTA,0,0,0,0,0,0,0,0,0,0,0,0,0,0,0,0
1987,27,TABASCO,27012,MACUSPANA,19,2,17,0,0,0,0,0,0,0,0,0,19,2,17,0
1988,27,TABASCO,27013,NACAJUCA,9,2,7,0,0,0,0,0,0,0,0,0,9,2,7,0
1989,27,TABASCO,27014,PARAISO,2,1,1,0,0,0,0,0,0,0,0,0,2,1,1,0
1990,27,TABASCO,27015,TACOTALPA,0,0,0,0,0,0,0,0,0,0,0,0,0,0,0,0
1991,27,TABASCO,27016,TEAPA,1,0,1,0,0,0,0,0,0,0,0,0,1,0,1,0
1992,27,TABASCO,27017,TENOSIQUE,7,3,4,0,0,0,0,0,0,0,0,0,7,3,4,0
1993,28,TAMAULIPAS,28001,ABASOLO,2,0,2,0,0,0,0,0,0,0,0,0,2,0,2,0
1994,28,TAMAULIPAS,28002,ALDAMA,5,1,4,0,0,0,0,0,0,0,0,0,5,1,4,0
1995,28,TAMAULIPAS,28003,ALTAMIRA,23,12,11,0,0,0,0,0,0,0,0,0,23,12,11,0
1996,28,TAMAULIPAS,28004,ANTIGUO MORELOS,0,0,0,0,0,0,0,0,0,0,0,0,0,0,0,0
1997,28,TAMAULIPAS,28005,BURGOS,0,0,0,0,0,0,0,0,0,0,0,0,0,0,0,0
1998,28,TAMAULIPAS,28006,BUSTAMANTE,0,0,0,0,0,0,0,0,0,0,0,0,0,0,0,0
1999,28,TAMAULIPAS,28007,CAMARGO,0,0,0,0,0,0,0,0,0,0,0,0,0,0,0,0
2000,28,TAMAULIPAS,28008,CASAS,1,0,1,0,0,0,0,0,0,0,0,0,1,0,1,0
2001,28,TAMAULIPAS,28009,CIUDAD MADERO,0,0,0,0,0,0,0,0,0,0,0,0,0,0,0,0
2002,28,TAMAULIPAS,28010,CRUILLAS,2,0,2,0,0,0,0,0,0,0,0,0,2,0,2,0
2003,28,TAMAULIPAS,28011,GOMEZ FARIAS,0,0,0,0,0,0,0,0,0,0,0,0,0,0,0,0
2004,28,TAMAULIPAS,28012,GONZALEZ,23,4,19,0,0,0,0,0,0,0,0,0,23,4,19,0
2005,28,TAMAULIPAS,28013,GUEMEZ,37,5,32,0,0,0,0,0,0,0,0,0,37,5,32,0
2006,28,TAMAULIPAS,28014,GUERRERO,0,0,0,0,0,0,0,0,0,0,0,0,0,0,0,0
2007,28,TAMAULIPAS,28015,GUSTAVO DIAZ ORDAZ,0,0,0,0,0,0,0,0,0,0,0,0,0,0,0,0
2008,28,TAMAULIPAS,28016,HIDALGO,12,1,11,0,0,0,0,0,0,0,0,0,12,1,11,0
2009,28,TAMAULIPAS,28017,JAUMAVE,2,1,1,0,0,0,0,0,0,0,0,0,2,1,1,0
2010,28,TAMAULIPAS,28018,JIMENEZ,24,2,22,0,0,0,0,0,0,0,0,0,24,2,22,0
2011,28,TAMAULIPAS,28019,LLERA,6,4,2,0,0,0,0,0,0,0,0,0,6,4,2,0
2012,28,TAMAULIPAS,28020,MAINERO,0,0,0,0,0,0,0,0,0,0,0,0,0,0,0,0
2013,28,TAMAULIPAS,28021,EL MANTE,10,0,10,0,0,0,0,0,0,0,0,0,10,0,10,0
2014,28,TAMAULIPAS,28022,MATAMOROS,52,35,17,0,0,0,0,0,0,0,0,0,52,35,17,0
2015,28,TAMAULIPAS,28023,MENDEZ,0,0,0,0,0,0,0,0,0,0,0,0,0,0,0,0
2016,28,TAMAULIPAS,28024,MIER,0,0,0,0,0,0,0,0,0,0,0,0,0,0,0,0
2017,28,TAMAULIPAS,28025,MIGUEL ALEMAN,1,1,0,0,0,0,0,0,0,0,0,0,1,1,0,0
2018,28,TAMAULIPAS,28026,MIQUIHUANA,0,0,0,0,0,0,0,0,0,0,0,0,0,0,0,0
2019,28,TAMAULIPAS,28027,NUEVO LAREDO,47,10,37,0,0,0,0,0,0,0,0,0,47,10,37,0
2020,28,TAMAULIPAS,28028,NUEVO MORELOS,0,0,0,0,0,0,0,0,0,0,0,0,0,0,0,0
2021,28,TAMAULIPAS,28029,OCAMPO,0,0,0,0,0,0,0,0,0,0,0,0,0,0,0,0
2022,28,TAMAULIPAS,28030,PADILLA,7,1,6,0,0,0,0,0,0,0,0,0,7,1,6,0
2023,28,TAMAULIPAS,28031,PALMILLAS,0,0,0,0,0,0,0,0,0,0,0,0,0,0,0,0
2024,28,TAMAULIPAS,28032,REYNOSA,99,32,67,0,0,0,0,0,0,0,0,0,99,32,67,0
2025,28,TAMAULIPAS,28033,RIO BRAVO,0,0,0,0,0,0,0,0,0,0,0,0,0,0,0,0
2026,28,TAMAULIPAS,28034,SAN CARLOS,0,0,0,0,0,0,0,0,0,0,0,0,0,0,0,0
2027,28,TAMAULIPAS,28035,SAN FERNANDO,25,9,16,0,0,0,0,0,0,0,0,0,25,9,16,0
2028,28,TAMAULIPAS,28036,SAN NICOLAS,0,0,0,0,0,0,0,0,0,0,0,0,0,0,0,0
2029,28,TAMAULIPAS,28037,SOTO LA MARINA,9,0,9,0,0,0,0,0,0,0,0,0,9,0,9,0
2030,28,TAMAULIPAS,28038,TAMPICO,1,1,0,0,0,0,0,0,0,0,0,0,1,1,0,0
2031,28,TAMAULIPAS,28039,TULA,0,0,0,0,0,0,0,0,0,0,0,0,0,0,0,0
2032,28,TAMAULIPAS,28040,VALLE HERMOSO,0,0,0,0,0,0,0,0,0,0,0,0,0,0,0,0
2033,28,TAMAULIPAS,28041,VICTORIA,22,10,12,0,0,0,0,0,0,0,0,0,22,10,12,0
2034,28,TAMAULIPAS,28042,VILLAGRAN,2,0,2,0,0,0,0,0,0,0,0,0,2,0,2,0
2035,28,TAMAULIPAS,28043,XICOTENCATL,0,0,0,0,0,0,0,0,0,0,0,0,0,0,0,0
2036,29,TLAXCALA,29001,AMAXAC DE GUERRERO,0,0,0,0,0,0,0,0,0,0,0,0,0,0,0,0
2037,29,TLAXCALA,29002,APETATITLAN DE ANTONIO CARVAJAL,4,2,2,0,0,0,0,0,0,0,0,0,4,2,2,0
2038,29,TLAXCALA,29003,ATLANGATEPEC,2,1,1,0,0,0,0,0,0,0,0,0,2,1,1,0
2039,29,TLAXCALA,29004,ATLTZAYANCA,0,0,0,0,0,0,0,0,0,0,0,0,0,0,0,0
2040,29,TLAXCALA,29005,APIZACO,6,2,4,0,0,0,0,0,0,0,0,0,6,2,4,0
2041,29,TLAXCALA,29006,CALPULALPAN,69,52,17,0,0,0,0,0,0,0,0,0,69,52,17,0
2042,29,TLAXCALA,29007,EL CARMEN TEQUEXQUITLA,16,7,9,0,0,0,0,0,0,0,0,0,16,7,9,0
2043,29,TLAXCALA,29008,CUAPIAXTLA,27,6,21,0,0,0,0,0,0,0,0,0,27,6,21,0
2044,29,TLAXCALA,29009,CUAXOMULCO,0,0,0,0,0,0,0,0,0,0,0,0,0,0,0,0
2045,29,TLAXCALA,29010,CHIAUTEMPAN,2,1,1,0,0,0,0,0,0,0,0,0,2,1,1,0
2046,29,TLAXCALA,29011,MUÑOZ DE DOMINGO ARENAS,0,0,0,0,0,0,0,0,0,0,0,0,0,0,0,0
2047,29,TLAXCALA,29012,ESPAÑITA,1,0,1,0,0,0,0,0,0,0,0,0,1,0,1,0
2048,29,TLAXCALA,29013,HUAMANTLA,55,25,30,0,0,0,0,0,0,0,0,0,55,25,30,0
2049,29,TLAXCALA,29014,HUEYOTLIPAN,4,2,2,0,0,0,0,0,0,0,0,0,4,2,2,0
2050,29,TLAXCALA,29015,IXTACUIXTLA DE MARIANO MATAMOROS,23,15,8,0,0,0,0,0,0,0,0,0,23,15,8,0
2051,29,TLAXCALA,29016,IXTENCO,4,0,4,0,0,0,0,0,0,0,0,0,4,0,4,0
2052,29,TLAXCALA,29017,MAZATECOCHCO DE JOSE MARIA MORELOS,0,0,0,0,0,0,0,0,0,0,0,0,0,0,0,0
2053,29,TLAXCALA,29018,CONTLA DE JUAN CUAMATZI,0,0,0,0,0,0,0,0,0,0,0,0,0,0,0,0
2054,29,TLAXCALA,29019,TEPETITLA DE LARDIZABAL,6,5,1,0,0,0,0,0,0,0,0,0,6,5,1,0
2055,29,TLAXCALA,29020,SANCTORUM DE LAZARO CARDENAS,2,1,1,0,0,0,0,0,0,0,0,0,2,1,1,0
2056,29,TLAXCALA,29021,NANACAMILPA DE MARIANO ARISTA,3,2,1,0,0,0,0,0,0,0,0,0,3,2,1,0
2057,29,TLAXCALA,29022,ACUAMANALA DE MIGUEL HIDALGO,3,0,3,0,0,0,0,0,0,0,0,0,3,0,3,0
2058,29,TLAXCALA,29023,NATIVITAS,1,1,0,0,0,0,0,0,0,0,0,0,1,1,0,0
2059,29,TLAXCALA,29024,PANOTLA,1,1,0,0,0,0,0,0,0,0,0,0,1,1,0,0
2060,29,TLAXCALA,29025,SAN PABLO DEL MONTE,6,6,0,0,0,0,0,0,0,0,0,0,6,6,0,0
2061,29,TLAXCALA,29026,SANTA CRUZ TLAXCALA,0,0,0,0,0,0,0,0,0,0,0,0,0,0,0,0
2062,29,TLAXCALA,29027,TENANCINGO,4,2,2,0,0,0,0,0,0,0,0,0,4,2,2,0
2063,29,TLAXCALA,29028,TEOLOCHOLCO,4,1,3,0,0,0,0,0,0,0,0,0,4,1,3,0
2064,29,TLAXCALA,29029,TEPEYANCO,0,0,0,0,0,0,0,0,0,0,0,0,0,0,0,0
2065,29,TLAXCALA,29030,TERRENATE,0,0,0,0,0,0,0,0,0,0,0,0,0,0,0,0
2066,29,TLAXCALA,29031,TETLA DE LA SOLIDARIDAD,1,1,0,0,0,0,0,0,0,0,0,0,1,1,0,0
2067,29,TLAXCALA,29032,TETLATLAHUCA,0,0,0,0,0,0,0,0,0,0,0,0,0,0,0,0
2068,29,TLAXCALA,29033,TLAXCALA,5,5,0,0,0,0,0,0,0,0,0,0,5,5,0,0
2069,29,TLAXCALA,29034,TLAXCO,0,0,0,0,0,0,0,0,0,0,0,0,0,0,0,0
2070,29,TLAXCALA,29035,TOCATLAN,4,2,2,0,0,0,0,0,0,0,0,0,4,2,2,0
2071,29,TLAXCALA,29036,TOTOLAC,1,0,1,0,0,0,0,0,0,0,0,0,1,0,1,0
2072,29,TLAXCALA,29037,ZILTLALTEPEC DE TRINIDAD SANCHEZ SANTOS,2,1,1,0,0,0,0,0,0,0,0,0,2,1,1,0
2073,29,TLAXCALA,29038,TZOMPANTEPEC,0,0,0,0,0,0,0,0,0,0,0,0,0,0,0,0
2074,29,TLAXCALA,29039,XALOZTOC,0,0,0,0,0,0,0,0,0,0,0,0,0,0,0,0
2075,29,TLAXCALA,29040,XALTOCAN,2,2,0,0,0,0,0,0,0,0,0,0,2,2,0,0
2076,29,TLAXCALA,29041,PAPALOTLA DE XICOHTENCATL,0,0,0,0,0,0,0,0,0,0,0,0,0,0,0,0
2077,29,TLAXCALA,29042,XICOHTZINCO,0,0,0,0,0,0,0,0,0,0,0,0,0,0,0,0
2078,29,TLAXCALA,29043,YAUHQUEMEHCAN,5,3,2,0,0,0,0,0,0,0,0,0,5,3,2,0
2079,29,TLAXCALA,29044,ZACATELCO,0,0,0,0,0,0,0,0,0,0,0,0,0,0,0,0
2080,29,TLAXCALA,29045,BENITO JUAREZ,0,0,0,0,0,0,0,0,0,0,0,0,0,0,0,0
2081,29,TLAXCALA,29046,EMILIANO ZAPATA,0,0,0,0,0,0,0,0,0,0,0,0,0,0,0,0
2082,29,TLAXCALA,29047,LAZARO CARDENAS,0,0,0,0,0,0,0,0,0,0,0,0,0,0,0,0
2083,29,TLAXCALA,29048,LA MAGDALENA TLALTELULCO,0,0,0,0,0,0,0,0,0,0,0,0,0,0,0,0
2084,29,TLAXCALA,29049,SAN DAMIAN TEXOLOC,0,0,0,0,0,0,0,0,0,0,0,0,0,0,0,0
2085,29,TLAXCALA,29050,SAN FRANCISCO TETLANOHCAN,0,0,0,0,0,0,0,0,0,0,0,0,0,0,0,0
2086,29,TLAXCALA,29051,SAN JERONIMO ZACUALPAN,0,0,0,0,0,0,0,0,0,0,0,0,0,0,0,0
2087,29,TLAXCALA,29052,SAN JOSE TEACALCO,0,0,0,0,0,0,0,0,0,0,0,0,0,0,0,0
2088,29,TLAXCALA,29053,SAN JUAN HUACTZINCO,0,0,0,0,0,0,0,0,0,0,0,0,0,0,0,0
2089,29,TLAXCALA,29054,SAN LORENZO AXOCOMANITLA,0,0,0,0,0,0,0,0,0,0,0,0,0,0,0,0
2090,29,TLAXCALA,29055,SAN LUCAS TECOPILCO,0,0,0,0,0,0,0,0,0,0,0,0,0,0,0,0
2091,29,TLAXCALA,29056,SANTA ANA NOPALUCAN,1,0,1,0,0,0,0,0,0,0,0,0,1,0,1,0
2092,29,TLAXCALA,29057,SANTA APOLONIA TEACALCO,0,0,0,0,0,0,0,0,0,0,0,0,0,0,0,0
2093,29,TLAXCALA,29058,SANTA CATARINA AYOMETLA,0,0,0,0,0,0,0,0,0,0,0,0,0,0,0,0
2094,29,TLAXCALA,29059,SANTA CRUZ QUILEHTLA,0,0,0,0,0,0,0,0,0,0,0,0,0,0,0,0
2095,29,TLAXCALA,29060,SANTA ISABEL XILOXOXTLA,0,0,0,0,0,0,0,0,0,0,0,0,0,0,0,0
2096,30,VERACRUZ DE IGNACIO DE LA LLAVE,30001,ACAJETE,6,2,4,0,0,0,0,0,0,0,0,0,6,2,4,0
2097,30,VERACRUZ DE IGNACIO DE LA LLAVE,30002,ACATLAN,0,0,0,0,0,0,0,0,0,0,0,0,0,0,0,0
2098,30,VERACRUZ DE IGNACIO DE LA LLAVE,30003,ACAYUCAN,57,31,26,0,0,0,0,0,0,0,0,0,57,31,26,0
2099,30,VERACRUZ DE IGNACIO DE LA LLAVE,30004,ACTOPAN,7,6,1,0,0,0,0,0,0,0,0,0,7,6,1,0
2100,30,VERACRUZ DE IGNACIO DE LA LLAVE,30005,ACULA,0,0,0,0,0,0,0,0,0,0,0,0,0,0,0,0
2101,30,VERACRUZ DE IGNACIO DE LA LLAVE,30006,ACULTZINGO,0,0,0,0,0,0,0,0,0,0,0,0,0,0,0,0
2102,30,VERACRUZ DE IGNACIO DE LA LLAVE,30007,CAMARON DE TEJEDA,0,0,0,0,0,0,0,0,0,0,0,0,0,0,0,0
2103,30,VERACRUZ DE IGNACIO DE LA LLAVE,30008,ALPATLAHUAC,0,0,0,0,0,0,0,0,0,0,0,0,0,0,0,0
2104,30,VERACRUZ DE IGNACIO DE LA LLAVE,30009,ALTO LUCERO DE GUTIERREZ BARRIOS,5,5,0,0,0,0,0,0,0,0,0,0,5,5,0,0
2105,30,VERACRUZ DE IGNACIO DE LA LLAVE,30010,ALTOTONGA,3,3,0,0,0,0,0,0,0,0,0,0,3,3,0,0
2106,30,VERACRUZ DE IGNACIO DE LA LLAVE,30011,ALVARADO,7,4,3,0,0,0,0,0,0,0,0,0,7,4,3,0
2107,30,VERACRUZ DE IGNACIO DE LA LLAVE,30012,AMATITLAN,3,2,1,0,0,0,0,0,0,0,0,0,3,2,1,0
2108,30,VERACRUZ DE IGNACIO DE LA LLAVE,30013,NARANJOS AMATLAN,0,0,0,0,0,0,0,0,0,0,0,0,0,0,0,0
2109,30,VERACRUZ DE IGNACIO DE LA LLAVE,30014,AMATLAN DE LOS REYES,22,16,6,0,0,0,0,0,0,0,0,0,22,16,6,0
2110,30,VERACRUZ DE IGNACIO DE LA LLAVE,30015,ANGEL R CABADA,1,0,1,0,0,0,0,0,0,0,0,0,1,0,1,0
2111,30,VERACRUZ DE IGNACIO DE LA LLAVE,30016,LA ANTIGUA,6,0,6,0,0,0,0,0,0,0,0,0,6,0,6,0
2112,30,VERACRUZ DE IGNACIO DE LA LLAVE,30017,APAZAPAN,0,0,0,0,0,0,0,0,0,0,0,0,0,0,0,0
2113,30,VERACRUZ DE IGNACIO DE LA LLAVE,30018,AQUILA,0,0,0,0,0,0,0,0,0,0,0,0,0,0,0,0
2114,30,VERACRUZ DE IGNACIO DE LA LLAVE,30019,ASTACINGA,0,0,0,0,0,0,0,0,0,0,0,0,0,0,0,0
2115,30,VERACRUZ DE IGNACIO DE LA LLAVE,30020,ATLAHUILCO,0,0,0,0,0,0,0,0,0,0,0,0,0,0,0,0
2116,30,VERACRUZ DE IGNACIO DE LA LLAVE,30021,ATOYAC,0,0,0,0,0,0,0,0,0,0,0,0,0,0,0,0
2117,30,VERACRUZ DE IGNACIO DE LA LLAVE,30022,ATZACAN,0,0,0,0,0,0,0,0,0,0,0,0,0,0,0,0
2118,30,VERACRUZ DE IGNACIO DE LA LLAVE,30023,ATZALAN,1,1,0,0,0,0,0,0,0,0,0,0,1,1,0,0
2119,30,VERACRUZ DE IGNACIO DE LA LLAVE,30024,TLALTETELA,0,0,0,0,0,0,0,0,0,0,0,0,0,0,0,0
2120,30,VERACRUZ DE IGNACIO DE LA LLAVE,30025,AYAHUALULCO,0,0,0,0,0,0,0,0,0,0,0,0,0,0,0,0
2121,30,VERACRUZ DE IGNACIO DE LA LLAVE,30026,BANDERILLA,4,0,4,0,0,0,0,0,0,0,0,0,4,0,4,0
2122,30,VERACRUZ DE IGNACIO DE LA LLAVE,30027,BENITO JUAREZ,0,0,0,0,0,0,0,0,0,0,0,0,0,0,0,0
2123,30,VERACRUZ DE IGNACIO DE LA LLAVE,30028,BOCA DEL RIO,4,3,1,0,0,0,0,0,0,0,0,0,4,3,1,0
2124,30,VERACRUZ DE IGNACIO DE LA LLAVE,30029,CALCAHUALCO,0,0,0,0,0,0,0,0,0,0,0,0,0,0,0,0
2125,30,VERACRUZ DE IGNACIO DE LA LLAVE,30030,CAMERINO Z MENDOZA,0,0,0,0,0,0,0,0,0,0,0,0,0,0,0,0
2126,30,VERACRUZ DE IGNACIO DE LA LLAVE,30031,CARRILLO PUERTO,4,4,0,0,0,0,0,0,0,0,0,0,4,4,0,0
2127,30,VERACRUZ DE IGNACIO DE LA LLAVE,30032,CATEMACO,3,0,3,0,0,0,0,0,0,0,0,0,3,0,3,0
2128,30,VERACRUZ DE IGNACIO DE LA LLAVE,30033,CAZONES DE HERRERA,0,0,0,0,0,0,0,0,0,0,0,0,0,0,0,0
2129,30,VERACRUZ DE IGNACIO DE LA LLAVE,30034,CERRO AZUL,0,0,0,0,0,0,0,0,0,0,0,0,0,0,0,0
2130,30,VERACRUZ DE IGNACIO DE LA LLAVE,30035,CITLALTEPETL,0,0,0,0,0,0,0,0,0,0,0,0,0,0,0,0
2131,30,VERACRUZ DE IGNACIO DE LA LLAVE,30036,COACOATZINTLA,0,0,0,0,0,0,0,0,0,0,0,0,0,0,0,0
2132,30,VERACRUZ DE IGNACIO DE LA LLAVE,30037,COAHUITLAN,1,1,0,0,0,0,0,0,0,0,0,0,1,1,0,0
2133,30,VERACRUZ DE IGNACIO DE LA LLAVE,30038,COATEPEC,0,0,0,0,0,0,0,0,0,0,0,0,0,0,0,0
2134,30,VERACRUZ DE IGNACIO DE LA LLAVE,30039,COATZACOALCOS,4,2,2,0,0,0,0,0,0,0,0,0,4,2,2,0
2135,30,VERACRUZ DE IGNACIO DE LA LLAVE,30040,COATZINTLA,0,0,0,0,0,0,0,0,0,0,0,0,0,0,0,0
2136,30,VERACRUZ DE IGNACIO DE LA LLAVE,30041,COETZALA,0,0,0,0,0,0,0,0,0,0,0,0,0,0,0,0
2137,30,VERACRUZ DE IGNACIO DE LA LLAVE,30042,COLIPA,0,0,0,0,0,0,0,0,0,0,0,0,0,0,0,0
2138,30,VERACRUZ DE IGNACIO DE LA LLAVE,30043,COMAPA,0,0,0,0,0,0,0,0,0,0,0,0,0,0,0,0
2139,30,VERACRUZ DE IGNACIO DE LA LLAVE,30044,CORDOBA,19,13,6,0,0,0,0,0,0,0,0,0,19,13,6,0
2140,30,VERACRUZ DE IGNACIO DE LA LLAVE,30045,COSAMALOAPAN DE CARPIO,48,36,12,0,0,0,0,0,0,0,0,0,48,36,12,0
2141,30,VERACRUZ DE IGNACIO DE LA LLAVE,30046,COSAUTLAN DE CARVAJAL,0,0,0,0,0,0,0,0,0,0,0,0,0,0,0,0
2142,30,VERACRUZ DE IGNACIO DE LA LLAVE,30047,COSCOMATEPEC,0,0,0,0,0,0,0,0,0,0,0,0,0,0,0,0
2143,30,VERACRUZ DE IGNACIO DE LA LLAVE,30048,COSOLEACAQUE,13,4,9,0,0,0,0,0,0,0,0,0,13,4,9,0
2144,30,VERACRUZ DE IGNACIO DE LA LLAVE,30049,COTAXTLA,29,11,18,0,0,0,0,0,0,0,0,0,29,11,18,0
2145,30,VERACRUZ DE IGNACIO DE LA LLAVE,30050,COXQUIHUI,0,0,0,0,0,0,0,0,0,0,0,0,0,0,0,0
2146,30,VERACRUZ DE IGNACIO DE LA LLAVE,30051,COYUTLA,0,0,0,0,0,0,0,0,0,0,0,0,0,0,0,0
2147,30,VERACRUZ DE IGNACIO DE LA LLAVE,30052,CUICHAPA,0,0,0,0,0,0,0,0,0,0,0,0,0,0,0,0
2148,30,VERACRUZ DE IGNACIO DE LA LLAVE,30053,CUITLAHUAC,36,24,12,0,0,0,0,0,0,0,0,0,36,24,12,0
2149,30,VERACRUZ DE IGNACIO DE LA LLAVE,30054,CHACALTIANGUIS,0,0,0,0,0,0,0,0,0,0,0,0,0,0,0,0
2150,30,VERACRUZ DE IGNACIO DE LA LLAVE,30055,CHALMA,0,0,0,0,0,0,0,0,0,0,0,0,0,0,0,0
2151,30,VERACRUZ DE IGNACIO DE LA LLAVE,30056,CHICONAMEL,0,0,0,0,0,0,0,0,0,0,0,0,0,0,0,0
2152,30,VERACRUZ DE IGNACIO DE LA LLAVE,30057,CHICONQUIACO,0,0,0,0,0,0,0,0,0,0,0,0,0,0,0,0
2153,30,VERACRUZ DE IGNACIO DE LA LLAVE,30058,CHICONTEPEC,0,0,0,0,0,0,0,0,0,0,0,0,0,0,0,0
2154,30,VERACRUZ DE IGNACIO DE LA LLAVE,30059,CHINAMECA,1,1,0,0,0,0,0,0,0,0,0,0,1,1,0,0
2155,30,VERACRUZ DE IGNACIO DE LA LLAVE,30060,CHINAMPA DE GOROSTIZA,0,0,0,0,0,0,0,0,0,0,0,0,0,0,0,0
2156,30,VERACRUZ DE IGNACIO DE LA LLAVE,30061,LAS CHOAPAS,18,3,15,0,0,0,0,0,0,0,0,0,18,3,15,0
2157,30,VERACRUZ DE IGNACIO DE LA LLAVE,30062,CHOCAMAN,1,1,0,0,0,0,0,0,0,0,0,0,1,1,0,0
2158,30,VERACRUZ DE IGNACIO DE LA LLAVE,30063,CHONTLA,0,0,0,0,0,0,0,0,0,0,0,0,0,0,0,0
2159,30,VERACRUZ DE IGNACIO DE LA LLAVE,30064,CHUMATLAN,0,0,0,0,0,0,0,0,0,0,0,0,0,0,0,0
2160,30,VERACRUZ DE IGNACIO DE LA LLAVE,30065,EMILIANO ZAPATA,17,11,6,0,0,0,0,0,0,0,0,0,17,11,6,0
2161,30,VERACRUZ DE IGNACIO DE LA LLAVE,30066,ESPINAL,0,0,0,0,0,0,0,0,0,0,0,0,0,0,0,0
2162,30,VERACRUZ DE IGNACIO DE LA LLAVE,30067,FILOMENO MATA,1,0,1,0,0,0,0,0,0,0,0,0,1,0,1,0
2163,30,VERACRUZ DE IGNACIO DE LA LLAVE,30068,FORTIN,46,34,12,0,0,0,0,0,0,0,0,0,46,34,12,0
2164,30,VERACRUZ DE IGNACIO DE LA LLAVE,30069,GUTIERREZ ZAMORA,0,0,0,0,0,0,0,0,0,0,0,0,0,0,0,0
2165,30,VERACRUZ DE IGNACIO DE LA LLAVE,30070,HIDALGOTITLAN,0,0,0,0,0,0,0,0,0,0,0,0,0,0,0,0
2166,30,VERACRUZ DE IGNACIO DE LA LLAVE,30071,HUATUSCO,0,0,0,0,0,0,0,0,0,0,0,0,0,0,0,0
2167,30,VERACRUZ DE IGNACIO DE LA LLAVE,30072,HUAYACOCOTLA,0,0,0,0,0,0,0,0,0,0,0,0,0,0,0,0
2168,30,VERACRUZ DE IGNACIO DE LA LLAVE,30073,HUEYAPAN DE OCAMPO,3,1,2,0,0,0,0,0,0,0,0,0,3,1,2,0
2169,30,VERACRUZ DE IGNACIO DE LA LLAVE,30074,HUILOAPAN DE CUAUHTEMOC,27,18,9,0,0,0,0,0,0,0,0,0,27,18,9,0
2170,30,VERACRUZ DE IGNACIO DE LA LLAVE,30075,IGNACIO DE LA LLAVE,0,0,0,0,0,0,0,0,0,0,0,0,0,0,0,0
2171,30,VERACRUZ DE IGNACIO DE LA LLAVE,30076,ILAMATLAN,0,0,0,0,0,0,0,0,0,0,0,0,0,0,0,0
2172,30,VERACRUZ DE IGNACIO DE LA LLAVE,30077,ISLA,0,0,0,0,0,0,0,0,0,0,0,0,0,0,0,0
2173,30,VERACRUZ DE IGNACIO DE LA LLAVE,30078,IXCATEPEC,0,0,0,0,0,0,0,0,0,0,0,0,0,0,0,0
2174,30,VERACRUZ DE IGNACIO DE LA LLAVE,30079,IXHUACAN DE LOS REYES,0,0,0,0,0,0,0,0,0,0,0,0,0,0,0,0
2175,30,VERACRUZ DE IGNACIO DE LA LLAVE,30080,IXHUATLAN DEL CAFE,0,0,0,0,0,0,0,0,0,0,0,0,0,0,0,0
2176,30,VERACRUZ DE IGNACIO DE LA LLAVE,30081,IXHUATLANCILLO,0,0,0,0,0,0,0,0,0,0,0,0,0,0,0,0
2177,30,VERACRUZ DE IGNACIO DE LA LLAVE,30082,IXHUATLAN DEL SURESTE,0,0,0,0,0,0,0,0,0,0,0,0,0,0,0,0
2178,30,VERACRUZ DE IGNACIO DE LA LLAVE,30083,IXHUATLAN DE MADERO,0,0,0,0,0,0,0,0,0,0,0,0,0,0,0,0
2179,30,VERACRUZ DE IGNACIO DE LA LLAVE,30084,IXMATLAHUACAN,0,0,0,0,0,0,0,0,0,0,0,0,0,0,0,0
2180,30,VERACRUZ DE IGNACIO DE LA LLAVE,30085,IXTACZOQUITLAN,12,10,2,0,0,0,0,0,0,0,0,0,12,10,2,0
2181,30,VERACRUZ DE IGNACIO DE LA LLAVE,30086,JALACINGO,0,0,0,0,0,0,0,0,0,0,0,0,0,0,0,0
2182,30,VERACRUZ DE IGNACIO DE LA LLAVE,30087,XALAPA,11,6,5,0,0,0,0,0,0,0,0,0,11,6,5,0
2183,30,VERACRUZ DE IGNACIO DE LA LLAVE,30088,JALCOMULCO,0,0,0,0,0,0,0,0,0,0,0,0,0,0,0,0
2184,30,VERACRUZ DE IGNACIO DE LA LLAVE,30089,JALTIPAN,0,0,0,0,0,0,0,0,0,0,0,0,0,0,0,0
2185,30,VERACRUZ DE IGNACIO DE LA LLAVE,30090,JAMAPA,1,1,0,0,0,0,0,0,0,0,0,0,1,1,0,0
2186,30,VERACRUZ DE IGNACIO DE LA LLAVE,30091,JESUS CARRANZA,0,0,0,0,0,0,0,0,0,0,0,0,0,0,0,0
2187,30,VERACRUZ DE IGNACIO DE LA LLAVE,30092,XICO,0,0,0,0,0,0,0,0,0,0,0,0,0,0,0,0
2188,30,VERACRUZ DE IGNACIO DE LA LLAVE,30093,JILOTEPEC,0,0,0,0,0,0,0,0,0,0,0,0,0,0,0,0
2189,30,VERACRUZ DE IGNACIO DE LA LLAVE,30094,JUAN RODRIGUEZ CLARA,5,2,3,0,0,0,0,0,0,0,0,0,5,2,3,0
2190,30,VERACRUZ DE IGNACIO DE LA LLAVE,30095,JUCHIQUE DE FERRER,0,0,0,0,0,0,0,0,0,0,0,0,0,0,0,0
2191,30,VERACRUZ DE IGNACIO DE LA LLAVE,30096,LANDERO Y COSS,0,0,0,0,0,0,0,0,0,0,0,0,0,0,0,0
2192,30,VERACRUZ DE IGNACIO DE LA LLAVE,30097,LERDO DE TEJADA,1,1,0,0,0,0,0,0,0,0,0,0,1,1,0,0
2193,30,VERACRUZ DE IGNACIO DE LA LLAVE,30098,MAGDALENA,0,0,0,0,0,0,0,0,0,0,0,0,0,0,0,0
2194,30,VERACRUZ DE IGNACIO DE LA LLAVE,30099,MALTRATA,15,8,7,0,0,0,0,0,0,0,0,0,15,8,7,0
2195,30,VERACRUZ DE IGNACIO DE LA LLAVE,30100,MANLIO FABIO ALTAMIRANO,0,0,0,0,0,0,0,0,0,0,0,0,0,0,0,0
2196,30,VERACRUZ DE IGNACIO DE LA LLAVE,30101,MARIANO ESCOBEDO,0,0,0,0,0,0,0,0,0,0,0,0,0,0,0,0
2197,30,VERACRUZ DE IGNACIO DE LA LLAVE,30102,MARTINEZ DE LA TORRE,19,9,10,0,0,0,0,0,0,0,0,0,19,9,10,0
2198,30,VERACRUZ DE IGNACIO DE LA LLAVE,30103,MECATLAN,0,0,0,0,0,0,0,0,0,0,0,0,0,0,0,0
2199,30,VERACRUZ DE IGNACIO DE LA LLAVE,30104,MECAYAPAN,0,0,0,0,0,0,0,0,0,0,0,0,0,0,0,0
2200,30,VERACRUZ DE IGNACIO DE LA LLAVE,30105,MEDELLIN DE BRAVO,13,3,10,0,0,0,0,0,0,0,0,0,13,3,10,0
2201,30,VERACRUZ DE IGNACIO DE LA LLAVE,30106,MIAHUATLAN,0,0,0,0,0,0,0,0,0,0,0,0,0,0,0,0
2202,30,VERACRUZ DE IGNACIO DE LA LLAVE,30107,LAS MINAS,0,0,0,0,0,0,0,0,0,0,0,0,0,0,0,0
2203,30,VERACRUZ DE IGNACIO DE LA LLAVE,30108,MINATITLAN,0,0,0,0,0,0,0,0,0,0,0,0,0,0,0,0
2204,30,VERACRUZ DE IGNACIO DE LA LLAVE,30109,MISANTLA,0,0,0,0,0,0,0,0,0,0,0,0,0,0,0,0
2205,30,VERACRUZ DE IGNACIO DE LA LLAVE,30110,MIXTLA DE ALTAMIRANO,0,0,0,0,0,0,0,0,0,0,0,0,0,0,0,0
2206,30,VERACRUZ DE IGNACIO DE LA LLAVE,30111,MOLOACAN,0,0,0,0,0,0,0,0,0,0,0,0,0,0,0,0
2207,30,VERACRUZ DE IGNACIO DE LA LLAVE,30112,NAOLINCO,0,0,0,0,0,0,0,0,0,0,0,0,0,0,0,0
2208,30,VERACRUZ DE IGNACIO DE LA LLAVE,30113,NARANJAL,1,0,1,0,0,0,0,0,0,0,0,0,1,0,1,0
2209,30,VERACRUZ DE IGNACIO DE LA LLAVE,30114,NAUTLA,5,4,1,0,0,0,0,0,0,0,0,0,5,4,1,0
2210,30,VERACRUZ DE IGNACIO DE LA LLAVE,30115,NOGALES,15,9,6,0,0,0,0,0,0,0,0,0,15,9,6,0
2211,30,VERACRUZ DE IGNACIO DE LA LLAVE,30116,OLUTA,1,1,0,0,0,0,0,0,0,0,0,0,1,1,0,0
2212,30,VERACRUZ DE IGNACIO DE LA LLAVE,30117,OMEALCA,1,1,0,0,0,0,0,0,0,0,0,0,1,1,0,0
2213,30,VERACRUZ DE IGNACIO DE LA LLAVE,30118,ORIZABA,21,15,6,0,0,0,0,0,0,0,0,0,21,15,6,0
2214,30,VERACRUZ DE IGNACIO DE LA LLAVE,30119,OTATITLAN,0,0,0,0,0,0,0,0,0,0,0,0,0,0,0,0
2215,30,VERACRUZ DE IGNACIO DE LA LLAVE,30120,OTEAPAN,0,0,0,0,0,0,0,0,0,0,0,0,0,0,0,0
2216,30,VERACRUZ DE IGNACIO DE LA LLAVE,30121,OZULUAMA DE MASCAREÑAS,8,0,8,0,0,0,0,0,0,0,0,0,8,0,8,0
2217,30,VERACRUZ DE IGNACIO DE LA LLAVE,30122,PAJAPAN,0,0,0,0,0,0,0,0,0,0,0,0,0,0,0,0
2218,30,VERACRUZ DE IGNACIO DE LA LLAVE,30123,PANUCO,24,1,23,0,0,0,0,0,0,0,0,0,24,1,23,0
2219,30,VERACRUZ DE IGNACIO DE LA LLAVE,30124,PAPANTLA,11,2,9,0,0,0,0,0,0,0,0,0,11,2,9,0
2220,30,VERACRUZ DE IGNACIO DE LA LLAVE,30125,PASO DEL MACHO,0,0,0,0,0,0,0,0,0,0,0,0,0,0,0,0
2221,30,VERACRUZ DE IGNACIO DE LA LLAVE,30126,PASO DE OVEJAS,0,0,0,0,0,0,0,0,0,0,0,0,0,0,0,0
2222,30,VERACRUZ DE IGNACIO DE LA LLAVE,30127,LA PERLA,1,1,0,0,0,0,0,0,0,0,0,0,1,1,0,0
2223,30,VERACRUZ DE IGNACIO DE LA LLAVE,30128,PEROTE,57,44,13,0,0,0,0,0,0,0,0,0,57,44,13,0
2224,30,VERACRUZ DE IGNACIO DE LA LLAVE,30129,PLATON SANCHEZ,0,0,0,0,0,0,0,0,0,0,0,0,0,0,0,0
2225,30,VERACRUZ DE IGNACIO DE LA LLAVE,30130,PLAYA VICENTE,0,0,0,0,0,0,0,0,0,0,0,0,0,0,0,0
2226,30,VERACRUZ DE IGNACIO DE LA LLAVE,30131,POZA RICA DE HIDALGO,5,1,4,0,0,0,0,0,0,0,0,0,5,1,4,0
2227,30,VERACRUZ DE IGNACIO DE LA LLAVE,30132,LAS VIGAS DE RAMIREZ,14,5,9,0,0,0,0,0,0,0,0,0,14,5,9,0
2228,30,VERACRUZ DE IGNACIO DE LA LLAVE,30133,PUEBLO VIEJO,4,3,1,0,0,0,0,0,0,0,0,0,4,3,1,0
2229,30,VERACRUZ DE IGNACIO DE LA LLAVE,30134,PUENTE NACIONAL,11,1,10,0,0,0,0,0,0,0,0,0,11,1,10,0
2230,30,VERACRUZ DE IGNACIO DE LA LLAVE,30135,RAFAEL DELGADO,0,0,0,0,0,0,0,0,0,0,0,0,0,0,0,0
2231,30,VERACRUZ DE IGNACIO DE LA LLAVE,30136,RAFAEL LUCIO,1,1,0,0,0,0,0,0,0,0,0,0,1,1,0,0
2232,30,VERACRUZ DE IGNACIO DE LA LLAVE,30137,LOS REYES,0,0,0,0,0,0,0,0,0,0,0,0,0,0,0,0
2233,30,VERACRUZ DE IGNACIO DE LA LLAVE,30138,RIO BLANCO,4,4,0,0,0,0,0,0,0,0,0,0,4,4,0,0
2234,30,VERACRUZ DE IGNACIO DE LA LLAVE,30139,SALTABARRANCA,0,0,0,0,0,0,0,0,0,0,0,0,0,0,0,0
2235,30,VERACRUZ DE IGNACIO DE LA LLAVE,30140,SAN ANDRES TENEJAPAN,0,0,0,0,0,0,0,0,0,0,0,0,0,0,0,0
2236,30,VERACRUZ DE IGNACIO DE LA LLAVE,30141,SAN ANDRES TUXTLA,5,3,2,0,0,0,0,0,0,0,0,0,5,3,2,0
2237,30,VERACRUZ DE IGNACIO DE LA LLAVE,30142,SAN JUAN EVANGELISTA,0,0,0,0,0,0,0,0,0,0,0,0,0,0,0,0
2238,30,VERACRUZ DE IGNACIO DE LA LLAVE,30143,SANTIAGO TUXTLA,0,0,0,0,0,0,0,0,0,0,0,0,0,0,0,0
2239,30,VERACRUZ DE IGNACIO DE LA LLAVE,30144,SAYULA DE ALEMAN,8,4,4,0,0,0,0,0,0,0,0,0,8,4,4,0
2240,30,VERACRUZ DE IGNACIO DE LA LLAVE,30145,SOCONUSCO,1,1,0,0,0,0,0,0,0,0,0,0,1,1,0,0
2241,30,VERACRUZ DE IGNACIO DE LA LLAVE,30146,SOCHIAPA,0,0,0,0,0,0,0,0,0,0,0,0,0,0,0,0
2242,30,VERACRUZ DE IGNACIO DE LA LLAVE,30147,SOLEDAD ATZOMPA,0,0,0,0,0,0,0,0,0,0,0,0,0,0,0,0
2243,30,VERACRUZ DE IGNACIO DE LA LLAVE,30148,SOLEDAD DE DOBLADO,0,0,0,0,0,0,0,0,0,0,0,0,0,0,0,0
2244,30,VERACRUZ DE IGNACIO DE LA LLAVE,30149,SOTEAPAN,0,0,0,0,0,0,0,0,0,0,0,0,0,0,0,0
2245,30,VERACRUZ DE IGNACIO DE LA LLAVE,30150,TAMALIN,0,0,0,0,0,0,0,0,0,0,0,0,0,0,0,0
2246,30,VERACRUZ DE IGNACIO DE LA LLAVE,30151,TAMIAHUA,1,0,1,0,0,0,0,0,0,0,0,0,1,0,1,0
2247,30,VERACRUZ DE IGNACIO DE LA LLAVE,30152,TAMPICO ALTO,0,0,0,0,0,0,0,0,0,0,0,0,0,0,0,0
2248,30,VERACRUZ DE IGNACIO DE LA LLAVE,30153,TANCOCO,0,0,0,0,0,0,0,0,0,0,0,0,0,0,0,0
2249,30,VERACRUZ DE IGNACIO DE LA LLAVE,30154,TANTIMA,0,0,0,0,0,0,0,0,0,0,0,0,0,0,0,0
2250,30,VERACRUZ DE IGNACIO DE LA LLAVE,30155,TANTOYUCA,5,2,3,0,0,0,0,0,0,0,0,0,5,2,3,0
2251,30,VERACRUZ DE IGNACIO DE LA LLAVE,30156,TATATILA,0,0,0,0,0,0,0,0,0,0,0,0,0,0,0,0
2252,30,VERACRUZ DE IGNACIO DE LA LLAVE,30157,CASTILLO DE TEAYO,0,0,0,0,0,0,0,0,0,0,0,0,0,0,0,0
2253,30,VERACRUZ DE IGNACIO DE LA LLAVE,30158,TECOLUTLA,0,0,0,0,0,0,0,0,0,0,0,0,0,0,0,0
2254,30,VERACRUZ DE IGNACIO DE LA LLAVE,30159,TEHUIPANGO,0,0,0,0,0,0,0,0,0,0,0,0,0,0,0,0
2255,30,VERACRUZ DE IGNACIO DE LA LLAVE,30160,ALAMO TEMAPACHE,16,7,9,0,0,0,0,0,0,0,0,0,16,7,9,0
2256,30,VERACRUZ DE IGNACIO DE LA LLAVE,30161,TEMPOAL,4,1,3,0,0,0,0,0,0,0,0,0,4,1,3,0
2257,30,VERACRUZ DE IGNACIO DE LA LLAVE,30162,TENAMPA,0,0,0,0,0,0,0,0,0,0,0,0,0,0,0,0
2258,30,VERACRUZ DE IGNACIO DE LA LLAVE,30163,TENOCHTITLAN,0,0,0,0,0,0,0,0,0,0,0,0,0,0,0,0
2259,30,VERACRUZ DE IGNACIO DE LA LLAVE,30164,TEOCELO,0,0,0,0,0,0,0,0,0,0,0,0,0,0,0,0
2260,30,VERACRUZ DE IGNACIO DE LA LLAVE,30165,TEPATLAXCO,0,0,0,0,0,0,0,0,0,0,0,0,0,0,0,0
2261,30,VERACRUZ DE IGNACIO DE LA LLAVE,30166,TEPETLAN,0,0,0,0,0,0,0,0,0,0,0,0,0,0,0,0
2262,30,VERACRUZ DE IGNACIO DE LA LLAVE,30167,TEPETZINTLA,0,0,0,0,0,0,0,0,0,0,0,0,0,0,0,0
2263,30,VERACRUZ DE IGNACIO DE LA LLAVE,30168,TEQUILA,0,0,0,0,0,0,0,0,0,0,0,0,0,0,0,0
2264,30,VERACRUZ DE IGNACIO DE LA LLAVE,30169,JOSE AZUETA,0,0,0,0,0,0,0,0,0,0,0,0,0,0,0,0
2265,30,VERACRUZ DE IGNACIO DE LA LLAVE,30170,TEXCATEPEC,0,0,0,0,0,0,0,0,0,0,0,0,0,0,0,0
2266,30,VERACRUZ DE IGNACIO DE LA LLAVE,30171,TEXHUACAN,0,0,0,0,0,0,0,0,0,0,0,0,0,0,0,0
2267,30,VERACRUZ DE IGNACIO DE LA LLAVE,30172,TEXISTEPEC,0,0,0,0,0,0,0,0,0,0,0,0,0,0,0,0
2268,30,VERACRUZ DE IGNACIO DE LA LLAVE,30173,TEZONAPA,0,0,0,0,0,0,0,0,0,0,0,0,0,0,0,0
2269,30,VERACRUZ DE IGNACIO DE LA LLAVE,30174,TIERRA BLANCA,16,10,6,0,0,0,0,0,0,0,0,0,16,10,6,0
2270,30,VERACRUZ DE IGNACIO DE LA LLAVE,30175,TIHUATLAN,55,15,40,0,0,0,0,0,0,0,0,0,55,15,40,0
2271,30,VERACRUZ DE IGNACIO DE LA LLAVE,30176,TLACOJALPAN,0,0,0,0,0,0,0,0,0,0,0,0,0,0,0,0
2272,30,VERACRUZ DE IGNACIO DE LA LLAVE,30177,TLACOLULAN,0,0,0,0,0,0,0,0,0,0,0,0,0,0,0,0
2273,30,VERACRUZ DE IGNACIO DE LA LLAVE,30178,TLACOTALPAN,0,0,0,0,0,0,0,0,0,0,0,0,0,0,0,0
2274,30,VERACRUZ DE IGNACIO DE LA LLAVE,30179,TLACOTEPEC DE MEJIA,0,0,0,0,0,0,0,0,0,0,0,0,0,0,0,0
2275,30,VERACRUZ DE IGNACIO DE LA LLAVE,30180,TLACHICHILCO,0,0,0,0,0,0,0,0,0,0,0,0,0,0,0,0
2276,30,VERACRUZ DE IGNACIO DE LA LLAVE,30181,TLALIXCOYAN,1,1,0,0,0,0,0,0,0,0,0,0,1,1,0,0
2277,30,VERACRUZ DE IGNACIO DE LA LLAVE,30182,TLALNELHUAYOCAN,0,0,0,0,0,0,0,0,0,0,0,0,0,0,0,0
2278,30,VERACRUZ DE IGNACIO DE LA LLAVE,30183,TLAPACOYAN,2,0,2,0,0,0,0,0,0,0,0,0,2,0,2,0
2279,30,VERACRUZ DE IGNACIO DE LA LLAVE,30184,TLAQUILPA,0,0,0,0,0,0,0,0,0,0,0,0,0,0,0,0
2280,30,VERACRUZ DE IGNACIO DE LA LLAVE,30185,TLILAPAN,2,2,0,0,0,0,0,0,0,0,0,0,2,2,0,0
2281,30,VERACRUZ DE IGNACIO DE LA LLAVE,30186,TOMATLAN,0,0,0,0,0,0,0,0,0,0,0,0,0,0,0,0
2282,30,VERACRUZ DE IGNACIO DE LA LLAVE,30187,TONAYAN,0,0,0,0,0,0,0,0,0,0,0,0,0,0,0,0
2283,30,VERACRUZ DE IGNACIO DE LA LLAVE,30188,TOTUTLA,0,0,0,0,0,0,0,0,0,0,0,0,0,0,0,0
2284,30,VERACRUZ DE IGNACIO DE LA LLAVE,30189,TUXPAN,23,3,20,0,0,0,0,0,0,0,0,0,23,3,20,0
2285,30,VERACRUZ DE IGNACIO DE LA LLAVE,30190,TUXTILLA,0,0,0,0,0,0,0,0,0,0,0,0,0,0,0,0
2286,30,VERACRUZ DE IGNACIO DE LA LLAVE,30191,URSULO GALVAN,1,0,1,0,0,0,0,0,0,0,0,0,1,0,1,0
2287,30,VERACRUZ DE IGNACIO DE LA LLAVE,30192,VEGA DE ALATORRE,3,3,0,0,0,0,0,0,0,0,0,0,3,3,0,0
2288,30,VERACRUZ DE IGNACIO DE LA LLAVE,30193,VERACRUZ,92,40,52,0,0,0,0,0,0,0,0,0,92,40,52,0
2289,30,VERACRUZ DE IGNACIO DE LA LLAVE,30194,VILLA ALDAMA,2,2,0,0,0,0,0,0,0,0,0,0,2,2,0,0
2290,30,VERACRUZ DE IGNACIO DE LA LLAVE,30195,XOXOCOTLA,0,0,0,0,0,0,0,0,0,0,0,0,0,0,0,0
2291,30,VERACRUZ DE IGNACIO DE LA LLAVE,30196,YANGA,10,6,4,0,0,0,0,0,0,0,0,0,10,6,4,0
2292,30,VERACRUZ DE IGNACIO DE LA LLAVE,30197,YECUATLA,0,0,0,0,0,0,0,0,0,0,0,0,0,0,0,0
2293,30,VERACRUZ DE IGNACIO DE LA LLAVE,30198,ZACUALPAN,0,0,0,0,0,0,0,0,0,0,0,0,0,0,0,0
2294,30,VERACRUZ DE IGNACIO DE LA LLAVE,30199,ZARAGOZA,0,0,0,0,0,0,0,0,0,0,0,0,0,0,0,0
2295,30,VERACRUZ DE IGNACIO DE LA LLAVE,30200,ZENTLA,0,0,0,0,0,0,0,0,0,0,0,0,0,0,0,0
2296,30,VERACRUZ DE IGNACIO DE LA LLAVE,30201,ZONGOLICA,0,0,0,0,0,0,0,0,0,0,0,0,0,0,0,0
2297,30,VERACRUZ DE IGNACIO DE LA LLAVE,30202,ZONTECOMATLAN DE LOPEZ Y FUENTES,0,0,0,0,0,0,0,0,0,0,0,0,0,0,0,0
2298,30,VERACRUZ DE IGNACIO DE LA LLAVE,30203,ZOZOCOLCO DE HIDALGO,0,0,0,0,0,0,0,0,0,0,0,0,0,0,0,0
2299,30,VERACRUZ DE IGNACIO DE LA LLAVE,30204,AGUA DULCE,1,0,1,0,0,0,0,0,0,0,0,0,1,0,1,0
2300,30,VERACRUZ DE IGNACIO DE LA LLAVE,30205,EL HIGO,0,0,0,0,0,0,0,0,0,0,0,0,0,0,0,0
2301,30,VERACRUZ DE IGNACIO DE LA LLAVE,30206,NANCHITAL DE LAZARO CARDENAS DEL RIO,26,13,13,0,0,0,0,0,0,0,0,0,26,13,13,0
2302,30,VERACRUZ DE IGNACIO DE LA LLAVE,30207,TRES VALLES,4,3,1,0,0,0,0,0,0,0,0,0,4,3,1,0
2303,30,VERACRUZ DE IGNACIO DE LA LLAVE,30208,CARLOS A CARRILLO,2,2,0,0,0,0,0,0,0,0,0,0,2,2,0,0
2304,30,VERACRUZ DE IGNACIO DE LA LLAVE,30209,TATAHUICAPAN DE JUAREZ,0,0,0,0,0,0,0,0,0,0,0,0,0,0,0,0
2305,30,VERACRUZ DE IGNACIO DE LA LLAVE,30210,UXPANAPA,0,0,0,0,0,0,0,0,0,0,0,0,0,0,0,0
2306,30,VERACRUZ DE IGNACIO DE LA LLAVE,30211,SAN RAFAEL,0,0,0,0,0,0,0,0,0,0,0,0,0,0,0,0
2307,30,VERACRUZ DE IGNACIO DE LA LLAVE,30212,SANTIAGO SOCHIAPAN,0,0,0,0,0,0,0,0,0,0,0,0,0,0,0,0
2308,31,YUCATAN,31001,ABALA,0,0,0,0,0,0,0,0,0,0,0,0,0,0,0,0
2309,31,YUCATAN,31002,ACANCEH,0,0,0,0,0,0,0,0,0,0,0,0,0,0,0,0
2310,31,YUCATAN,31003,AKIL,0,0,0,0,0,0,0,0,0,0,0,0,0,0,0,0
2311,31,YUCATAN,31004,BACA,0,0,0,0,0,0,0,0,0,0,0,0,0,0,0,0
2312,31,YUCATAN,31005,BOKOBA,0,0,0,0,0,0,0,0,0,0,0,0,0,0,0,0
2313,31,YUCATAN,31006,BUCTZOTZ,2,2,0,0,0,0,0,0,0,0,0,0,2,2,0,0
2314,31,YUCATAN,31007,CACALCHEN,0,0,0,0,0,0,0,0,0,0,0,0,0,0,0,0
2315,31,YUCATAN,31008,CALOTMUL,0,0,0,0,0,0,0,0,0,0,0,0,0,0,0,0
2316,31,YUCATAN,31009,CANSAHCAB,0,0,0,0,0,0,0,0,0,0,0,0,0,0,0,0
2317,31,YUCATAN,31010,CANTAMAYEC,0,0,0,0,0,0,0,0,0,0,0,0,0,0,0,0
2318,31,YUCATAN,31011,CELESTUN,0,0,0,0,0,0,0,0,0,0,0,0,0,0,0,0
2319,31,YUCATAN,31012,CENOTILLO,0,0,0,0,0,0,0,0,0,0,0,0,0,0,0,0
2320,31,YUCATAN,31013,CONKAL,0,0,0,0,0,0,0,0,0,0,0,0,0,0,0,0
2321,31,YUCATAN,31014,CUNCUNUL,0,0,0,0,0,0,0,0,0,0,0,0,0,0,0,0
2322,31,YUCATAN,31015,CUZAMA,0,0,0,0,0,0,0,0,0,0,0,0,0,0,0,0
2323,31,YUCATAN,31016,CHACSINKIN,0,0,0,0,0,0,0,0,0,0,0,0,0,0,0,0
2324,31,YUCATAN,31017,CHANKOM,0,0,0,0,0,0,0,0,0,0,0,0,0,0,0,0
2325,31,YUCATAN,31018,CHAPAB,0,0,0,0,0,0,0,0,0,0,0,0,0,0,0,0
2326,31,YUCATAN,31019,CHEMAX,3,1,2,0,0,0,0,0,0,0,0,0,3,1,2,0
2327,31,YUCATAN,31020,CHICXULUB PUEBLO,0,0,0,0,0,0,0,0,0,0,0,0,0,0,0,0
2328,31,YUCATAN,31021,CHICHIMILA,0,0,0,0,0,0,0,0,0,0,0,0,0,0,0,0
2329,31,YUCATAN,31022,CHIKINDZONOT,0,0,0,0,0,0,0,0,0,0,0,0,0,0,0,0
2330,31,YUCATAN,31023,CHOCHOLA,0,0,0,0,0,0,0,0,0,0,0,0,0,0,0,0
2331,31,YUCATAN,31024,CHUMAYEL,0,0,0,0,0,0,0,0,0,0,0,0,0,0,0,0
2332,31,YUCATAN,31025,DZAN,0,0,0,0,0,0,0,0,0,0,0,0,0,0,0,0
2333,31,YUCATAN,31026,DZEMUL,0,0,0,0,0,0,0,0,0,0,0,0,0,0,0,0
2334,31,YUCATAN,31027,DZIDZANTUN,0,0,0,0,0,0,0,0,0,0,0,0,0,0,0,0
2335,31,YUCATAN,31028,DZILAM DE BRAVO,0,0,0,0,0,0,0,0,0,0,0,0,0,0,0,0
2336,31,YUCATAN,31029,DZILAM GONZALEZ,0,0,0,0,0,0,0,0,0,0,0,0,0,0,0,0
2337,31,YUCATAN,31030,DZITAS,0,0,0,0,0,0,0,0,0,0,0,0,0,0,0,0
2338,31,YUCATAN,31031,DZONCAUICH,0,0,0,0,0,0,0,0,0,0,0,0,0,0,0,0
2339,31,YUCATAN,31032,ESPITA,0,0,0,0,0,0,0,0,0,0,0,0,0,0,0,0
2340,31,YUCATAN,31033,HALACHO,2,0,2,0,0,0,0,0,0,0,0,0,2,0,2,0
2341,31,YUCATAN,31034,HOCABA,0,0,0,0,0,0,0,0,0,0,0,0,0,0,0,0
2342,31,YUCATAN,31035,HOCTUN,0,0,0,0,0,0,0,0,0,0,0,0,0,0,0,0
2343,31,YUCATAN,31036,HOMUN,0,0,0,0,0,0,0,0,0,0,0,0,0,0,0,0
2344,31,YUCATAN,31037,HUHI,0,0,0,0,0,0,0,0,0,0,0,0,0,0,0,0
2345,31,YUCATAN,31038,HUNUCMA,0,0,0,0,0,0,0,0,0,0,0,0,0,0,0,0
2346,31,YUCATAN,31039,IXIL,0,0,0,0,0,0,0,0,0,0,0,0,0,0,0,0
2347,31,YUCATAN,31040,IZAMAL,0,0,0,0,0,0,0,0,0,0,0,0,0,0,0,0
2348,31,YUCATAN,31041,KANASIN,0,0,0,0,0,0,0,0,0,0,0,0,0,0,0,0
2349,31,YUCATAN,31042,KANTUNIL,0,0,0,0,0,0,0,0,0,0,0,0,0,0,0,0
2350,31,YUCATAN,31043,KAUA,0,0,0,0,0,0,0,0,0,0,0,0,0,0,0,0
2351,31,YUCATAN,31044,KINCHIL,0,0,0,0,0,0,0,0,0,0,0,0,0,0,0,0
2352,31,YUCATAN,31045,KOPOMA,0,0,0,0,0,0,0,0,0,0,0,0,0,0,0,0
2353,31,YUCATAN,31046,MAMA,0,0,0,0,0,0,0,0,0,0,0,0,0,0,0,0
2354,31,YUCATAN,31047,MANI,0,0,0,0,0,0,0,0,0,0,0,0,0,0,0,0
2355,31,YUCATAN,31048,MAXCANU,2,0,2,0,0,0,0,0,0,0,0,0,2,0,2,0
2356,31,YUCATAN,31049,MAYAPAN,0,0,0,0,0,0,0,0,0,0,0,0,0,0,0,0
2357,31,YUCATAN,31050,MERIDA,7,2,5,0,0,0,0,0,0,0,0,0,7,2,5,0
2358,31,YUCATAN,31051,MOCOCHA,0,0,0,0,0,0,0,0,0,0,0,0,0,0,0,0
2359,31,YUCATAN,31052,MOTUL,1,1,0,0,0,0,0,0,0,0,0,0,1,1,0,0
2360,31,YUCATAN,31053,MUNA,0,0,0,0,0,0,0,0,0,0,0,0,0,0,0,0
2361,31,YUCATAN,31054,MUXUPIP,0,0,0,0,0,0,0,0,0,0,0,0,0,0,0,0
2362,31,YUCATAN,31055,OPICHEN,0,0,0,0,0,0,0,0,0,0,0,0,0,0,0,0
2363,31,YUCATAN,31056,OXKUTZCAB,0,0,0,0,0,0,0,0,0,0,0,0,0,0,0,0
2364,31,YUCATAN,31057,PANABA,0,0,0,0,0,0,0,0,0,0,0,0,0,0,0,0
2365,31,YUCATAN,31058,PETO,1,1,0,0,0,0,0,0,0,0,0,0,1,1,0,0
2366,31,YUCATAN,31059,PROGRESO,0,0,0,0,0,0,0,0,0,0,0,0,0,0,0,0
2367,31,YUCATAN,31060,QUINTANA ROO,0,0,0,0,0,0,0,0,0,0,0,0,0,0,0,0
2368,31,YUCATAN,31061,RIO LAGARTOS,0,0,0,0,0,0,0,0,0,0,0,0,0,0,0,0
2369,31,YUCATAN,31062,SACALUM,0,0,0,0,0,0,0,0,0,0,0,0,0,0,0,0
2370,31,YUCATAN,31063,SAMAHIL,0,0,0,0,0,0,0,0,0,0,0,0,0,0,0,0
2371,31,YUCATAN,31064,SANAHCAT,0,0,0,0,0,0,0,0,0,0,0,0,0,0,0,0
2372,31,YUCATAN,31065,SAN FELIPE,0,0,0,0,0,0,0,0,0,0,0,0,0,0,0,0
2373,31,YUCATAN,31066,SANTA ELENA,0,0,0,0,0,0,0,0,0,0,0,0,0,0,0,0
2374,31,YUCATAN,31067,SEYE,0,0,0,0,0,0,0,0,0,0,0,0,0,0,0,0
2375,31,YUCATAN,31068,SINANCHE,0,0,0,0,0,0,0,0,0,0,0,0,0,0,0,0
2376,31,YUCATAN,31069,SOTUTA,0,0,0,0,0,0,0,0,0,0,0,0,0,0,0,0
2377,31,YUCATAN,31070,SUCILA,0,0,0,0,0,0,0,0,0,0,0,0,0,0,0,0
2378,31,YUCATAN,31071,SUDZAL,0,0,0,0,0,0,0,0,0,0,0,0,0,0,0,0
2379,31,YUCATAN,31072,SUMA,0,0,0,0,0,0,0,0,0,0,0,0,0,0,0,0
2380,31,YUCATAN,31073,TAHDZIU,0,0,0,0,0,0,0,0,0,0,0,0,0,0,0,0
2381,31,YUCATAN,31074,TAHMEK,0,0,0,0,0,0,0,0,0,0,0,0,0,0,0,0
2382,31,YUCATAN,31075,TEABO,0,0,0,0,0,0,0,0,0,0,0,0,0,0,0,0
2383,31,YUCATAN,31076,TECOH,0,0,0,0,0,0,0,0,0,0,0,0,0,0,0,0
2384,31,YUCATAN,31077,TEKAL DE VENEGAS,0,0,0,0,0,0,0,0,0,0,0,0,0,0,0,0
2385,31,YUCATAN,31078,TEKANTO,0,0,0,0,0,0,0,0,0,0,0,0,0,0,0,0
2386,31,YUCATAN,31079,TEKAX,0,0,0,0,0,0,0,0,0,0,0,0,0,0,0,0
2387,31,YUCATAN,31080,TEKIT,0,0,0,0,0,0,0,0,0,0,0,0,0,0,0,0
2388,31,YUCATAN,31081,TEKOM,0,0,0,0,0,0,0,0,0,0,0,0,0,0,0,0
2389,31,YUCATAN,31082,TELCHAC PUEBLO,0,0,0,0,0,0,0,0,0,0,0,0,0,0,0,0
2390,31,YUCATAN,31083,TELCHAC PUERTO,0,0,0,0,0,0,0,0,0,0,0,0,0,0,0,0
2391,31,YUCATAN,31084,TEMAX,0,0,0,0,0,0,0,0,0,0,0,0,0,0,0,0
2392,31,YUCATAN,31085,TEMOZON,0,0,0,0,0,0,0,0,0,0,0,0,0,0,0,0
2393,31,YUCATAN,31086,TEPAKAN,0,0,0,0,0,0,0,0,0,0,0,0,0,0,0,0
2394,31,YUCATAN,31087,TETIZ,0,0,0,0,0,0,0,0,0,0,0,0,0,0,0,0
2395,31,YUCATAN,31088,TEYA,4,0,4,0,0,0,0,0,0,0,0,0,4,0,4,0
2396,31,YUCATAN,31089,TICUL,0,0,0,0,0,0,0,0,0,0,0,0,0,0,0,0
2397,31,YUCATAN,31090,TIMUCUY,0,0,0,0,0,0,0,0,0,0,0,0,0,0,0,0
2398,31,YUCATAN,31091,TINUM,0,0,0,0,0,0,0,0,0,0,0,0,0,0,0,0
2399,31,YUCATAN,31092,TIXCACALCUPUL,0,0,0,0,0,0,0,0,0,0,0,0,0,0,0,0
2400,31,YUCATAN,31093,TIXKOKOB,0,0,0,0,0,0,0,0,0,0,0,0,0,0,0,0
2401,31,YUCATAN,31094,TIXMEHUAC,0,0,0,0,0,0,0,0,0,0,0,0,0,0,0,0
2402,31,YUCATAN,31095,TIXPEHUAL,0,0,0,0,0,0,0,0,0,0,0,0,0,0,0,0
2403,31,YUCATAN,31096,TIZIMIN,7,7,0,0,0,0,0,0,0,0,0,0,7,7,0,0
2404,31,YUCATAN,31097,TUNKAS,0,0,0,0,0,0,0,0,0,0,0,0,0,0,0,0
2405,31,YUCATAN,31098,TZUCACAB,0,0,0,0,0,0,0,0,0,0,0,0,0,0,0,0
2406,31,YUCATAN,31099,UAYMA,0,0,0,0,0,0,0,0,0,0,0,0,0,0,0,0
2407,31,YUCATAN,31100,UCU,0,0,0,0,0,0,0,0,0,0,0,0,0,0,0,0
2408,31,YUCATAN,31101,UMAN,13,5,8,0,0,0,0,0,0,0,0,0,13,5,8,0
2409,31,YUCATAN,31102,VALLADOLID,20,17,3,0,0,0,0,0,0,0,0,0,20,17,3,0
2410,31,YUCATAN,31103,XOCCHEL,0,0,0,0,0,0,0,0,0,0,0,0,0,0,0,0
2411,31,YUCATAN,31104,YAXCABA,0,0,0,0,0,0,0,0,0,0,0,0,0,0,0,0
2412,31,YUCATAN,31105,YAXKUKUL,0,0,0,0,0,0,0,0,0,0,0,0,0,0,0,0
2413,31,YUCATAN,31106,YOBAIN,0,0,0,0,0,0,0,0,0,0,0,0,0,0,0,0
2414,32,ZACATECAS,32001,APOZOL,0,0,0,0,0,0,0,0,0,0,0,0,0,0,0,0
2415,32,ZACATECAS,32002,APULCO,0,0,0,0,0,0,0,0,0,0,0,0,0,0,0,0
2416,32,ZACATECAS,32003,ATOLINGA,0,0,0,0,0,0,0,0,0,0,0,0,0,0,0,0
2417,32,ZACATECAS,32004,BENITO JUAREZ,0,0,0,0,0,0,0,0,0,0,0,0,0,0,0,0
2418,32,ZACATECAS,32005,CALERA,4,2,2,0,0,0,0,0,0,0,0,0,4,2,2,0
2419,32,ZACATECAS,32006,CAÑITAS DE FELIPE PESCADOR,0,0,0,0,0,0,0,0,0,0,0,0,0,0,0,0
2420,32,ZACATECAS,32007,CONCEPCION DEL ORO,5,4,1,0,0,0,0,0,0,0,0,0,5,4,1,0
2421,32,ZACATECAS,32008,CUAUHTEMOC,0,0,0,0,0,0,0,0,0,0,0,0,0,0,0,0
2422,32,ZACATECAS,32009,CHALCHIHUITES,0,0,0,0,0,0,0,0,0,0,0,0,0,0,0,0
2423,32,ZACATECAS,32010,FRESNILLO,42,25,17,0,0,0,0,0,0,0,0,0,42,25,17,0
2424,32,ZACATECAS,32011,TRINIDAD GARCIA DE LA CADENA,0,0,0,0,0,0,0,0,0,0,0,0,0,0,0,0
2425,32,ZACATECAS,32012,GENARO CODINA,0,0,0,0,0,0,0,0,0,0,0,0,0,0,0,0
2426,32,ZACATECAS,32013,GENERAL ENRIQUE ESTRADA,0,0,0,0,0,0,0,0,0,0,0,0,0,0,0,0
2427,32,ZACATECAS,32014,GENERAL FRANCISCO R MURGUIA,0,0,0,0,0,0,0,0,0,0,0,0,0,0,0,0
2428,32,ZACATECAS,32015,EL PLATEADO DE JOAQUIN AMARO,0,0,0,0,0,0,0,0,0,0,0,0,0,0,0,0
2429,32,ZACATECAS,32016,GENERAL PANFILO NATERA,11,5,6,0,0,0,0,0,0,0,0,0,11,5,6,0
2430,32,ZACATECAS,32017,GUADALUPE,5,2,3,0,0,0,0,0,0,0,0,0,5,2,3,0
2431,32,ZACATECAS,32018,HUANUSCO,0,0,0,0,0,0,0,0,0,0,0,0,0,0,0,0
2432,32,ZACATECAS,32019,JALPA,9,8,1,0,0,0,0,0,0,0,0,0,9,8,1,0
2433,32,ZACATECAS,32020,JEREZ,5,5,0,0,0,0,0,0,0,0,0,0,5,5,0,0
2434,32,ZACATECAS,32021,JIMENEZ DEL TEUL,0,0,0,0,0,0,0,0,0,0,0,0,0,0,0,0
2435,32,ZACATECAS,32022,JUAN ALDAMA,0,0,0,0,0,0,0,0,0,0,0,0,0,0,0,0
2436,32,ZACATECAS,32023,JUCHIPILA,0,0,0,0,0,0,0,0,0,0,0,0,0,0,0,0
2437,32,ZACATECAS,32024,LORETO,0,0,0,0,0,0,0,0,0,0,0,0,0,0,0,0
2438,32,ZACATECAS,32025,LUIS MOYA,0,0,0,0,0,0,0,0,0,0,0,0,0,0,0,0
2439,32,ZACATECAS,32026,MAZAPIL,14,14,0,0,0,0,0,0,0,0,0,0,14,14,0,0
2440,32,ZACATECAS,32027,MELCHOR OCAMPO,0,0,0,0,0,0,0,0,0,0,0,0,0,0,0,0
2441,32,ZACATECAS,32028,MEZQUITAL DEL ORO,0,0,0,0,0,0,0,0,0,0,0,0,0,0,0,0
2442,32,ZACATECAS,32029,MIGUEL AUZA,0,0,0,0,0,0,0,0,0,0,0,0,0,0,0,0
2443,32,ZACATECAS,32030,MOMAX,0,0,0,0,0,0,0,0,0,0,0,0,0,0,0,0
2444,32,ZACATECAS,32031,MONTE ESCOBEDO,0,0,0,0,0,0,0,0,0,0,0,0,0,0,0,0
2445,32,ZACATECAS,32032,MORELOS,2,1,1,0,0,0,0,0,0,0,0,0,2,1,1,0
2446,32,ZACATECAS,32033,MOYAHUA DE ESTRADA,1,1,0,0,0,0,0,0,0,0,0,0,1,1,0,0
2447,32,ZACATECAS,32034,NOCHISTLAN DE MEJIA,2,2,0,0,0,0,0,0,0,0,0,0,2,2,0,0
2448,32,ZACATECAS,32035,NORIA DE ANGELES,0,0,0,0,0,0,0,0,0,0,0,0,0,0,0,0
2449,32,ZACATECAS,32036,OJOCALIENTE,2,1,1,0,0,0,0,0,0,0,0,0,2,1,1,0
2450,32,ZACATECAS,32037,PANUCO,0,0,0,0,0,0,0,0,0,0,0,0,0,0,0,0
2451,32,ZACATECAS,32038,PINOS,2,2,0,0,0,0,0,0,0,0,0,0,2,2,0,0
2452,32,ZACATECAS,32039,RIO GRANDE,5,2,3,0,0,0,0,0,0,0,0,0,5,2,3,0
2453,32,ZACATECAS,32040,SAIN ALTO,0,0,0,0,0,0,0,0,0,0,0,0,0,0,0,0
2454,32,ZACATECAS,32041,EL SALVADOR,0,0,0,0,0,0,0,0,0,0,0,0,0,0,0,0
2455,32,ZACATECAS,32042,SOMBRERETE,5,3,2,0,0,0,0,0,0,0,0,0,5,3,2,0
2456,32,ZACATECAS,32043,SUSTICACAN,0,0,0,0,0,0,0,0,0,0,0,0,0,0,0,0
2457,32,ZACATECAS,32044,TABASCO,3,2,1,0,0,0,0,0,0,0,0,0,3,2,1,0
2458,32,ZACATECAS,32045,TEPECHITLAN,0,0,0,0,0,0,0,0,0,0,0,0,0,0,0,0
2459,32,ZACATECAS,32046,TEPETONGO,1,1,0,0,0,0,0,0,0,0,0,0,1,1,0,0
2460,32,ZACATECAS,32047,TEUL DE GONZALEZ ORTEGA,0,0,0,0,0,0,0,0,0,0,0,0,0,0,0,0
2461,32,ZACATECAS,32048,TLALTENANGO DE SANCHEZ ROMAN,0,0,0,0,0,0,0,0,0,0,0,0,0,0,0,0
2462,32,ZACATECAS,32049,VALPARAISO,7,7,0,0,0,0,0,0,0,0,0,0,7,7,0,0
2463,32,ZACATECAS,32050,VETAGRANDE,6,0,6,0,0,0,0,0,0,0,0,0,6,0,6,0
2464,32,ZACATECAS,32051,VILLA DE COS,18,17,1,0,0,0,0,0,0,0,0,0,18,17,1,0
2465,32,ZACATECAS,32052,VILLA GARCIA,0,0,0,0,0,0,0,0,0,0,0,0,0,0,0,0
2466,32,ZACATECAS,32053,VILLA GONZALEZ ORTEGA,0,0,0,0,0,0,0,0,0,0,0,0,0,0,0,0
2467,32,ZACATECAS,32054,VILLA HIDALGO,0,0,0,0,0,0,0,0,0,0,0,0,0,0,0,0
2468,32,ZACATECAS,32055,VILLANUEVA,1,1,0,0,0,0,0,0,0,0,0,0,1,1,0,0
2469,32,ZACATECAS,32056,ZACATECAS,14,6,8,0,0,0,0,0,0,0,0,0,14,6,8,0
2470,32,ZACATECAS,32057,TRANCOSO,23,5,18,0,0,0,0,0,0,0,0,0,23,5,18,0
2471,32,ZACATECAS,32058,SANTA MARIA DE LA PAZ,0,0,0,0,0,0,0,0,0,0,0,0,0,0,0,0
2472,34,NO IDENTIFICADO,34999,NO IDENTIFICADO,5,1,4,0,0,0,0,0,0,0,0,0,5,1,4,0
99997,99,NO ESPECIFICADO,99997,NO ESPECIFICADO,,,,,,,,,,,,,,,,
